aaa	Ghotuo	aaa					
aab	Alumu-Tesu	aab					Arum-Tesu
aac	Ari	aac					
aad	Amal	aad					
aae	Arbëreshë Albanian	aae					
aaf	Aranadan	aaf					
aag	Ambrak	aag					
aah	Abu' Arapesh	aah					
aai	Arifama-Miniafia	aai					
aak	Ankave	aak					
aal	Afade	aal					
aam	Aramanik	aam					
aan	Anambé	aan					
aao	Algerian Saharan Arabic	aao					
aap	Pará Arára	aap					
aaq	Eastern Abnaki	aaq					
aar	Afar	aar	aar	aar	aa	aa	afar
aas	Aasáx	aas					
aat	Arvanitika Albanian	aat					
aau	Abau	aau					
aaw	Solong	aaw					
aax	Mandobo Atas	aax					
aaz	Amarasi	aaz					
aba	Abé	aba					
abb	Bankon	abb					
abc	Ambala Ayta	abc					
abd	Manide	abd					
abe	Western Abnaki	abe					Abenaki
abf	Abai Sungai	abf					
abg	Abaga	abg					
abh	Tajiki Arabic	abh					
abi	Abidji	abi					
abj	Aka-Bea	abj					
abk	Abkhazian	abk	abk	abk	ab	ab	Abkhaz;Abchasisch;abkhaze
abl	Lampung Nyo	abl					
abm	Abanyom	abm					
abn	Abua	abn					
abo	Abon	abo					
abp	Abellen Ayta	abp					
abq	Abaza	abq					
abr	Abron	abr					
abs	Ambonese Malay	abs					
abt	Ambulas	abt					
abu	Abure	abu					
abv	Baharna Arabic	abv					
abw	Pal	abw					
abx	Inabaknon	abx					
aby	Aneme Wake	aby					
abz	Abui	abz					
aca	Achagua	aca					
acb	Áncá	acb					
acd	Gikyode	acd					
ace	Achinese	ace	ace	ace			Acehnese;aceh
acf	Saint Lucian Creole French	acf					
ach	Acoli	ach	ach	ach			acoli;Acholi
aci	Aka-Cari	aci					
ack	Aka-Kora	ack					
acl	Akar-Bale	acl					
acm	Mesopotamian Arabic	acm					
acn	Achang	acn					
acp	Eastern Acipa	acp					
acq	Ta'izzi-Adeni Arabic	acq					
acr	Achi	acr					
acs	Acroá	acs					
act	Achterhoeks	act					
acu	Achuar-Shiwiar	acu					
acv	Achumawi	acv					
acw	Hijazi Arabic	acw					
acx	Omani Arabic	acx					
acy	Cypriot Arabic	acy					
acz	Acheron	acz					
ada	Adangme	ada	ada	ada			adangme
adb	Adabe	adb					
add	Dzodinka	add					
ade	Adele	ade					
adf	Dhofari Arabic	adf					
adg	Andegerebinha	adg					
adh	Adhola	adh					
adi	Adi	adi					
adj	Adioukrou	adj					
adl	Galo	adl					
adn	Adang	adn					
ado	Abu	ado					
adp	Adap	adp					
adq	Adangbe	adq					
adr	Adonara	adr					
ads	Adamorobe Sign Language	ads					
adt	Adnyamathanha	adt					
adu	Aduge	adu					
adw	Amundava	adw					
adx	Amdo Tibetan	adx					
ady	Adyghe	ady	ady	ady			adyghé;Adygei;Tscherkessisch (Adygeisch);Adygeisch
adz	Adzera	adz				azr	
aea	Areba	aea					
aeb	Tunisian Arabic	aeb					
aec	Saidi Arabic	aec					
aed	Argentine Sign Language	aed					
aee	Northeast Pashayi	aee					
aek	Haeke	aek					
ael	Ambele	ael					
aem	Arem	aem					
aen	Armenian Sign Language	aen					
aeq	Aer	aeq					
aer	Eastern Arrernte	aer					
aes	Alsea	aes					
aeu	Akeu	aeu					
aew	Ambakich	aew					
aey	Amele	aey					
aez	Aeka	aez					
afb	Gulf Arabic	afb					
afd	Andai	afd					
afe	Putukwam	afe					
afg	Afghan Sign Language	afg					
afh	Afrihili	afh	afh	afh			afrihili
afi	Akrukay	afi					
afk	Nanubae	afk					
afn	Defaka	afn					
afo	Eloyi	afo					
afp	Tapei	afp					
afr	Afrikaans	afr	afr	afr	af	af	afrikaans
afs	Afro-Seminole Creole	afs					
aft	Afitti	aft					
afu	Awutu	afu					
afz	Obokuitai	afz					
aga	Aguano	aga					
agb	Legbo	agb					
agc	Agatu	agc					
agd	Agarabi	agd					
age	Angal	age					
agf	Arguni	agf					
agg	Angor	agg					
agh	Ngelima	agh					
agi	Agariya	agi					
agj	Argobba	agj					
agk	Isarog Agta	agk					
agl	Fembe	agl					
agm	Angaataha	agm					
agn	Agutaynen	agn					
ago	Tainae	ago					
agq	Aghem	agq					
agr	Aguaruna	agr					
ags	Esimbi	ags					
agt	Central Cagayan Agta	agt					
agu	Aguacateco	agu					
agv	Remontado Dumagat	agv					
agw	Kahua	agw					
agx	Aghul	agx					
agy	Southern Alta	agy					
agz	Mt. Iriga Agta	agz					
aha	Ahanta	aha					
ahb	Axamb	ahb					
ahg	Qimant	ahg					
ahh	Aghu	ahh					
ahi	Tiagbamrin Aizi	ahi					
ahk	Akha	ahk					
ahl	Igo	ahl					
ahm	Mobumrin Aizi	ahm					
ahn	Àhàn	ahn					
aho	Ahom	aho					
ahp	Aproumu Aizi	ahp					
ahr	Ahirani	ahr					
ahs	Ashe	ahs					
aht	Ahtena	aht					
aia	Arosi	aia					
aib	Ainu (China)	aib					
aic	Ainbai	aic					
aid	Alngith	aid					
aie	Amara	aie					
aif	Agi	aif					
aig	Antigua and Barbuda Creole English	aig					
aih	Ai-Cham	aih					
aii	Assyrian Neo-Aramaic	aii					
aij	Lishanid Noshan	aij					
aik	Ake	aik					
ail	Aimele	ail					
aim	Aimol	aim					
ain	Ainu (Japan)	ain	ain	ain			Ainu;aïnou
aio	Aiton	aio					
aip	Burumakok	aip					
aiq	Aimaq	aiq					
air	Airoran	air					
ais	Nataoran Amis	ais					
ait	Arikem	ait					
aiw	Aari	aiw				aiz	
aix	Aighon	aix					
aiy	Ali	aiy					
aja	Aja (Sudan)	aja					
ajg	Aja (Benin)	ajg					
aji	Ajië	aji					
ajn	Andajin	ajn					
ajp	South Levantine Arabic	ajp					
ajt	Judeo-Tunisian Arabic	ajt					
aju	Judeo-Moroccan Arabic	aju					
ajw	Ajawa	ajw					
ajz	Amri Karbi	ajz					
aka	Akan	aka	aka	aka	ak	ak	akan
akb	Batak Angkola	akb					
akc	Mpur	akc					
akd	Ukpet-Ehom	akd					
ake	Akawaio	ake					
akf	Akpa	akf					
akg	Anakalangu	akg					
akh	Angal Heneng	akh					
aki	Aiome	aki					
akj	Aka-Jeru	akj					
akk	Akkadian	akk	akk	akk			Akkadisch;akkadien
akl	Aklanon	akl					
akm	Aka-Bo	akm					
ako	Akurio	ako					
akp	Siwu	akp					
akq	Ak	akq					
akr	Araki	akr					
aks	Akaselem	aks					
akt	Akolet	akt					
aku	Akum	aku					
akv	Akhvakh	akv					
akw	Akwa	akw					
akx	Aka-Kede	akx					
aky	Aka-Kol	aky					
akz	Alabama	akz					
ala	Alago	ala					
alc	Qawasqar	alc					
ald	Alladian	ald					
ale	Aleut	ale	ale	ale			aléoute;Aleutisch
alf	Alege	alf					
alh	Alawa	alh					
ali	Amaimon	ali					
alj	Alangan	alj					
alk	Alak	alk					
all	Allar	all					
alm	Amblong	alm					
aln	Gheg Albanian	aln					
alo	Larike-Wakasihu	alo					
alp	Alune	alp					
alq	Algonquin	alq					
alr	Alutor	alr					
als	Tosk Albanian	als					Elsässisch (Alemannisch)
alt	Southern Altai	alt	alt	alt			altai du Sud;Altaiisch;Altaisch;Altajisch
alu	'Are'are	alu					
alw	Alaba-K’abeena	alw					
alx	Amol	alx					
aly	Alyawarr	aly					
alz	Alur	alz					
ama	Amanayé	ama					
amb	Ambo	amb					
amc	Amahuaca	amc					
ame	Yanesha'	ame					
amf	Hamer-Banna	amf					
amg	Amurdak	amg					
amh	Amharic	amh	amh	amh	am	am	Amharisch;amharique
ami	Amis	ami					
amj	Amdang	amj					
amk	Ambai	amk					
aml	War-Jaintia	aml					
amm	Ama (Papua New Guinea)	amm					
amn	Amanab	amn					
amo	Amo	amo					
amp	Alamblak	amp					
amq	Amahai	amq					
amr	Amarakaeri	amr					
ams	Southern Amami-Oshima	ams					
amt	Amto	amt					
amu	Guerrero Amuzgo	amu					Amuzgo
amv	Ambelau	amv					
amw	Western Neo-Aramaic	amw					
amx	Anmatyerre	amx					
amy	Ami	amy					
amz	Atampaya	amz					
ana	Andaqui	ana					
anb	Andoa	anb					
anc	Ngas	anc					
and	Ansus	and					
ane	Xârâcùù	ane					
anf	Animere	anf					
ang	Old English	ang	ang	ang			anglo-saxon (ca.450-1100);Altenglisch;Alt-Englisch;English, Old (ca.450-1100);Angelsächsisch;Old English (ca. 450-1100)
anh	Nend	anh					
ani	Andi	ani					
anj	Anor	anj					
ank	Goemai	ank					
anl	Anu-Hkongso Chin	anl					
anm	Anal	anm					
ann	Obolo	ann					
ano	Andoque	ano					
anp	Angika	anp	anp	anp			angika
anq	Jarawa (India)	anq					
anr	Andh	anr					
ans	Anserma	ans					
ant	Antakarinya	ant					
anu	Anuak	anu					
anv	Denya	anv					
anw	Anaang	anw					
anx	Andra-Hus	anx					
any	Anyin	any					
anz	Anem	anz					
aoa	Angolar	aoa					
aob	Abom	aob					
aoc	Pemon	aoc					
aod	Andarum	aod					
aoe	Angal Enen	aoe					
aof	Bragat	aof					
aog	Angoram	aog					
aoh	Arma	aoh					
aoi	Anindilyakwa	aoi					
aoj	Mufian	aoj					
aok	Arhö	aok					
aol	Alor	aol					
aom	Ömie	aom					
aon	Bumbita Arapesh	aon					
aor	Aore	aor					
aos	Taikat	aos					
aot	A'tong	aot					
aou	A'ou	aou					
aox	Atorada	aox					
aoz	Uab Meto	aoz					
apb	Sa'a	apb					
apc	North Levantine Arabic	apc					
apd	Sudanese Arabic	apd					
ape	Bukiyip	ape					
apf	Pahanan Agta	apf					
apg	Ampanang	apg					
aph	Athpariya	aph					
api	Apiaká	api					
apj	Jicarilla Apache	apj					Jicarilla
apk	Kiowa Apache	apk					Plains Apache
apl	Lipan Apache	apl					Lipan
apm	Mescalero-Chiricahua Apache	apm					Chiricahua
apn	Apinayé	apn					
apo	Ambul	apo					
app	Apma	app					
apq	A-Pucikwar	apq					
apr	Arop-Lokep	apr					
aps	Arop-Sissano	aps					
apt	Apatani	apt					
apu	Apurinã	apu					
apv	Alapmunte	apv					
apw	Western Apache	apw					
apx	Aputai	apx					
apy	Apalaí	apy					
apz	Safeyoka	apz					
aqc	Archi	aqc					
aqd	Ampari Dogon	aqd					
aqg	Arigidi	aqg					
aqm	Atohwaim	aqm					
aqn	Northern Alta	aqn					
aqp	Atakapa	aqp					
aqr	Arhâ	aqr					
aqz	Akuntsu	aqz					
ara	Arabic	ara	ara	ara	ar	arb;ar	arabe;Arabisch
arb	Standard Arabic	arb					
arc	Aramaic	arc	arc	arc		tmr	Official Aramaic (700-300 BCE);araméen d'empire (700-300 BCE);Imperial Aramaic (700-300 BCE)
ard	Arabana	ard					
are	Western Arrarnta	are					
arg	Aragonese	arg	arg	arg	an	an	aragonais;Aragonesisch
arh	Arhuaco	arh					
ari	Arikara	ari					
arj	Arapaso	arj					
ark	Arikapú	ark					
arl	Arabela	arl					
arn	Mapudungun	arn	arn	arn			mapuce;mapudungun;mapuche;Mapuche
aro	Araona	aro					
arp	Arapaho	arp	arp	arp			arapaho
arq	Algerian Arabic	arq					
arr	Karo (Brazil)	arr					
ars	Najdi Arabic	ars					
aru	Aruá (Amazonas State)	aru					Arua
arv	Arbore	arv					
arw	Arawak	arw	arw	arw			arawak
arx	Aruá (Rodonia State)	arx					
ary	Moroccan Arabic	ary					Moroccan;Marokkanisch
arz	Egyptian Arabic	arz					
asa	Asu (Tanzania)	asa					
asb	Assiniboine	asb					
asc	Casuarina Coast Asmat	asc					
asd	Asas	asd					
ase	American Sign Language	ase					
asf	Australian Sign Language	asf					
asg	Cishingini	asg					
ash	Abishira	ash					
asi	Buruwai	asi					
asj	Nsari	asj					
ask	Ashkun	ask					
asl	Asilulu	asl					
asm	Assamese	asm	asm	asm	as	as	Assamesisch;assamais
asn	Xingú Asuriní	asn					
aso	Dano	aso					
asp	Algerian Sign Language	asp					
asq	Austrian Sign Language	asq					
asr	Asuri	asr					
ass	Ipulo	ass					
ast	Asturian	ast	ast	ast			Asturleonese;Leonese;Bable;bable;léonais;asturien;Asturisch;asturoléonais
asu	Tocantins Asurini	asu					
asv	Asoa	asv					
asw	Australian Aborigines Sign Language	asw					
asx	Muratayak	asx					
asy	Yaosakor Asmat	asy					
asz	As	asz					
ata	Pele-Ata	ata					
atb	Zaiwa	atb					
atc	Atsahuaca	atc					
atd	Ata Manobo	atd					
ate	Atemble	ate					
atg	Ivbie North-Okpela-Arhe	atg					
ati	Attié	ati					
atj	Atikamekw	atj					
atk	Ati	atk					
atl	Mt. Iraya Agta	atl					
atm	Ata	atm					
atn	Ashtiani	atn					
ato	Atong	ato					
atp	Pudtol Atta	atp					
atq	Aralle-Tabulahan	atq					
atr	Waimiri-Atroari	atr					
ats	Gros Ventre	ats					
att	Pamplona Atta	att					
atu	Reel	atu					
atv	Northern Altai	atv					
atw	Atsugewi	atw					
atx	Arutani	atx					
aty	Aneityum	aty					
atz	Arta	atz					
aua	Asumboa	aua					
aub	Alugu	aub					
auc	Waorani	auc					
aud	Anuta	aud					
aue	=/Kx'au//'ein	aue					
aug	Aguna	aug					
auh	Aushi	auh					
aui	Anuki	aui					
auj	Awjilah	auj					
auk	Heyo	auk					
aul	Aulua	aul					
aum	Asu (Nigeria)	aum					
aun	Molmo One	aun					
auo	Auyokawa	auo					
aup	Makayam	aup					
auq	Anus	auq					
aur	Aruek	aur					
aut	Austral	aut					
auu	Auye	auu					
auw	Awyi	auw					
aux	Aurá	aux					
auy	Awiyaana	auy					
auz	Uzbeki Arabic	auz					
ava	Avaric	ava	ava	ava	av	av	Awarisch;Avar;avar;Avarisch
avb	Avau	avb					
avd	Alviri-Vidari	avd					
ave	Avestan	ave	ave	ave	ae	ae	Avestisch;avestique
avi	Avikam	avi					
avk	Kotava	avk					
avl	Eastern Egyptian Bedawi Arabic	avl					
avm	Angkamuthi	avm					
avn	Avatime	avn					
avo	Agavotaguerra	avo					
avs	Aushiri	avs					
avt	Au	avt					
avu	Avokaya	avu					
avv	Avá-Canoeiro	avv					
awa	Awadhi	awa	awa	awa			awadhi
awb	Awa (Papua New Guinea)	awb					
awc	Cicipu	awc					
awe	Awetí	awe					
awg	Anguthimri	awg					
awh	Awbono	awh					
awi	Aekyom	awi					
awk	Awabakal	awk					
awm	Arawum	awm					
awn	Awngi	awn					
awo	Awak	awo					
awr	Awera	awr					
aws	South Awyu	aws					
awt	Araweté	awt					
awu	Central Awyu	awu					
awv	Jair Awyu	awv					
aww	Awun	aww					
awx	Awara	awx					
awy	Edera Awyu	awy					
axb	Abipon	axb					
axe	Ayerrerenge	axe					
axg	Mato Grosso Arára	axg					
axk	Yaka (Central African Republic)	axk					
axm	Middle Armenian	axm					
axx	Xaragure	axx					
aya	Awar	aya					
ayb	Ayizo Gbe	ayb					
ayc	Southern Aymara	ayc					
ayd	Ayabadhu	ayd					
aye	Ayere	aye					
ayg	Ginyanga	ayg					
ayh	Hadrami Arabic	ayh					
ayi	Leyigha	ayi					
ayk	Akuku	ayk					
ayl	Libyan Arabic	ayl					Libyan
aym	Aymara	aym	aym	aym	ay	ay	Aimara;aymara
ayn	Sanaani Arabic	ayn					
ayo	Ayoreo	ayo					
ayp	North Mesopotamian Arabic	ayp					
ayq	Ayi (Papua New Guinea)	ayq					
ayr	Central Aymara	ayr					
ays	Sorsogon Ayta	ays					
ayt	Magbukun Ayta	ayt					
ayu	Ayu	ayu					
ayy	Tayabas Ayta	ayy					
ayz	Mai Brat	ayz					
aza	Azha	aza					
azb	South Azerbaijani	azb					Azerbaijani
azd	Eastern Durango Nahuatl	azd					
aze	Azerbaijani	aze	aze	aze	az	az	azéri;Nordaserbaidschanisch;Aserbaidschanisch;Azeri;Südaserbaidschanisch
azg	San Pedro Amuzgos Amuzgo	azg					
azj	North Azerbaijani	azj					
azm	Ipalapa Amuzgo	azm					
azn	Western Durango Nahuatl	azn					
azo	Awing	azo					
azt	Faire Atta	azt					
azz	Highland Puebla Nahuatl	azz					
baa	Babatana	baa					
bab	Bainouk-Gunyuño	bab					
bac	Badui	bac					
bae	Baré	bae					
baf	Nubaca	baf					
bag	Tuki	bag					
bah	Bahamas Creole English	bah					
baj	Barakai	baj					
bak	Bashkir	bak	bak	bak	ba	ba	bachkir;Baschkirisch
bal	Baluchi	bal	bal	bal			baloutchi;Belutschi
bam	Bambara	bam	bam	bam	bm	bm	bambara
ban	Balinese	ban	ban	ban			balinais;Balinesisch
bao	Waimaha	bao					
bap	Bantawa	bap					
bar	Bavarian	bar					Bairisch;Boarisch
bas	Basa (Cameroon)	bas	bas	bas			basa;Basa
bau	Bada (Nigeria)	bau					
bav	Vengo	bav					
baw	Bambili-Bambui	baw					
bax	Bamun	bax					
bay	Batuley	bay					
bba	Baatonum	bba					
bbb	Barai	bbb					
bbc	Batak Toba	bbc					
bbd	Bau	bbd					
bbe	Bangba	bbe					
bbf	Baibai	bbf					
bbg	Barama	bbg					
bbh	Bugan	bbh					
bbi	Barombi	bbi					
bbj	Ghomálá'	bbj					
bbk	Babanki	bbk					
bbl	Bats	bbl					
bbm	Babango	bbm					
bbn	Uneapa	bbn					
bbo	Northern Bobo Madaré	bbo					
bbp	West Central Banda	bbp					
bbq	Bamali	bbq					
bbr	Girawa	bbr					
bbs	Bakpinka	bbs					
bbt	Mburku	bbt					
bbu	Kulung (Nigeria)	bbu					
bbv	Karnai	bbv					
bbw	Baba	bbw					
bbx	Bubia	bbx					
bby	Befang	bby					
bbz	Babalia Creole Arabic	bbz					
bca	Central Bai	bca					
bcb	Bainouk-Samik	bcb					
bcc	Southern Balochi	bcc					
bcd	North Babar	bcd					
bce	Bamenyam	bce					
bcf	Bamu	bcf					
bcg	Baga Binari	bcg					
bch	Bariai	bch					
bci	Baoulé	bci					
bcj	Bardi	bcj					
bck	Bunaba	bck					
bcl	Central Bikol	bcl					
bcm	Bannoni	bcm					
bcn	Bali (Nigeria)	bcn					
bco	Kaluli	bco					
bcp	Bali (Democratic Republic of Congo)	bcp					
bcq	Bench	bcq					
bcr	Babine	bcr					
bcs	Kohumono	bcs					
bct	Bendi	bct					
bcu	Awad Bing	bcu					
bcv	Shoo-Minda-Nye	bcv					
bcw	Bana	bcw					
bcy	Bacama	bcy					
bcz	Bainouk-Gunyaamolo	bcz					
bda	Bayot	bda					
bdb	Basap	bdb					
bdc	Emberá-Baudó	bdc					
bdd	Bunama	bdd					
bde	Bade	bde					
bdf	Biage	bdf					
bdg	Bonggi	bdg					
bdh	Baka (Sudan)	bdh					
bdi	Burun	bdi					
bdj	Bai	bdj					
bdk	Budukh	bdk					
bdl	Indonesian Bajau	bdl					
bdm	Buduma	bdm					
bdn	Baldemu	bdn					
bdo	Morom	bdo					
bdp	Bende	bdp					
bdq	Bahnar	bdq					
bdr	West Coast Bajau	bdr					
bds	Burunge	bds					
bdt	Bokoto	bdt					
bdu	Oroko	bdu					
bdv	Bodo Parja	bdv					
bdw	Baham	bdw					
bdx	Budong-Budong	bdx					
bdy	Bandjalang	bdy					
bdz	Badeshi	bdz					
bea	Beaver	bea					
beb	Bebele	beb					
bec	Iceve-Maci	bec					
bed	Bedoanas	bed					
bee	Byangsi	bee					
bef	Benabena	bef					
beg	Belait	beg					
beh	Biali	beh					
bei	Bekati'	bei					
bej	Beja	bej	bej	bej			Bedawiyet;bedja
bek	Bebeli	bek					
bel	Belarusian	bel	bel	bel	be	be	Weißrussisch;biélorusse
bem	Bemba (Zambia)	bem	bem	bem			bemba;Bemba
ben	Bengali	ben	ben	ben	bn	bn	Bengalisch;bengali
beo	Beami	beo					
bep	Besoa	bep					
beq	Beembe	beq					
bes	Besme	bes					
bet	Guiberoua Béte	bet					
beu	Blagar	beu					
bev	Daloa Bété	bev					
bew	Betawi	bew					
bex	Jur Modo	bex					
bey	Beli (Papua New Guinea)	bey					
bez	Bena (Tanzania)	bez					
bfa	Bari	bfa					
bfb	Pauri Bareli	bfb					
bfc	Northern Bai	bfc					
bfd	Bafut	bfd					
bfe	Betaf	bfe					
bff	Bofi	bff					
bfg	Busang Kayan	bfg					
bfh	Blafe	bfh					
bfi	British Sign Language	bfi					
bfj	Bafanji	bfj					
bfk	Ban Khor Sign Language	bfk					
bfl	Banda-Ndélé	bfl					
bfm	Mmen	bfm					
bfn	Bunak	bfn					
bfo	Malba Birifor	bfo					
bfp	Beba	bfp					
bfq	Badaga	bfq					
bfr	Bazigar	bfr					
bfs	Southern Bai	bfs					
bft	Balti	bft					
bfu	Gahri	bfu					
bfw	Bondo	bfw					
bfx	Bantayanon	bfx					
bfy	Bagheli	bfy					
bfz	Mahasu Pahari	bfz					
bga	Gwamhi-Wuri	bga					
bgb	Bobongko	bgb					
bgc	Haryanvi	bgc					
bgd	Rathwi Bareli	bgd					
bge	Bauria	bge					
bgf	Bangandu	bgf					
bgg	Bugun	bgg					
bgi	Giangan	bgi					
bgj	Bangolan	bgj					
bgk	Bit	bgk					
bgl	Bo (Laos)	bgl					
bgm	Baga Mboteni	bgm					
bgn	Western Balochi	bgn					
bgo	Baga Koga	bgo					
bgp	Eastern Balochi	bgp					
bgq	Bagri	bgq					
bgr	Bawm Chin	bgr					
bgs	Tagabawa	bgs					
bgt	Bughotu	bgt					
bgu	Mbongno	bgu					
bgv	Warkay-Bipim	bgv					
bgw	Bhatri	bgw					
bgx	Balkan Gagauz Turkish	bgx					
bgy	Benggoi	bgy					
bgz	Banggai	bgz					
bha	Bharia	bha					
bhb	Bhili	bhb					
bhc	Biga	bhc					
bhd	Bhadrawahi	bhd					
bhe	Bhaya	bhe					
bhf	Odiai	bhf					
bhg	Binandere	bhg					
bhh	Bukharic	bhh					
bhi	Bhilali	bhi					
bhj	Bahing	bhj					
bhl	Bimin	bhl					
bhm	Bathari	bhm					
bhn	Bohtan Neo-Aramaic	bhn					
bho	Bhojpuri	bho	bho	bho			bhojpuri
bhp	Bima	bhp					
bhq	Tukang Besi South	bhq					
bhr	Bara Malagasy	bhr					
bhs	Buwal	bhs					
bht	Bhattiyali	bht					
bhu	Bhunjia	bhu					
bhv	Bahau	bhv					
bhw	Biak	bhw					
bhx	Bhalay	bhx					
bhy	Bhele	bhy					
bhz	Bada (Indonesia)	bhz					
bia	Badimaya	bia					
bib	Bissa	bib					
bic	Bikaru	bic					
bid	Bidiyo	bid					
bie	Bepour	bie					
bif	Biafada	bif					
big	Biangai	big					
bij	Vaghat-Ya-Bijim-Legeri	bij					
bik	Bikol	bik	bik	bik			bikol
bil	Bile	bil					
bim	Bimoba	bim					
bin	Bini	bin	bin	bin			Edo;edo;bini
bio	Nai	bio					
bip	Bila	bip					
biq	Bipi	biq					
bir	Bisorio	bir					
bis	Bislama	bis	bis	bis	bi	bi	Bislama (Bichelamar);bichlamar;Beach-la-Mar/Bislama
bit	Berinomo	bit					
biu	Biete	biu					
biv	Southern Birifor	biv					
biw	Kol (Cameroon)	biw					
bix	Bijori	bix					
biy	Birhor	biy					
biz	Baloi	biz					
bja	Budza	bja					
bjb	Banggarla	bjb					
bjc	Bariji	bjc					
bje	Biao-Jiao Mien	bje					
bjf	Barzani Jewish Neo-Aramaic	bjf					
bjg	Bidyogo	bjg					
bjh	Bahinemo	bjh					
bji	Burji	bji					
bjj	Kanauji	bjj					
bjk	Barok	bjk					
bjl	Bulu (Papua New Guinea)	bjl					
bjm	Bajelani	bjm					
bjn	Banjar	bjn					
bjo	Mid-Southern Banda	bjo					
bjr	Binumarien	bjr					
bjs	Bajan	bjs					
bjt	Balanta-Ganja	bjt					
bju	Busuu	bju					
bjv	Bedjond	bjv					
bjw	Bakwé	bjw					
bjx	Banao Itneg	bjx					
bjy	Bayali	bjy					
bjz	Baruga	bjz					
bka	Kyak	bka					
bkc	Baka (Cameroon)	bkc					
bkd	Binukid	bkd					
bkf	Beeke	bkf					
bkg	Buraka	bkg					
bkh	Bakoko	bkh					
bki	Baki	bki					
bkj	Pande	bkj					
bkk	Brokskat	bkk					
bkl	Berik	bkl					
bkm	Kom (Cameroon)	bkm					
bkn	Bukitan	bkn					
bko	Kwa'	bko					
bkp	Boko (Democratic Republic of Congo)	bkp					
bkq	Bakairí	bkq					
bkr	Bakumpai	bkr					
bks	Northern Sorsoganon	bks					
bkt	Boloki	bkt					
bku	Buhid	bku					
bkv	Bekwarra	bkv					
bkw	Bekwel	bkw					
bkx	Baikeno	bkx					
bky	Bokyi	bky					
bkz	Bungku	bkz					
bla	Siksika	bla	bla	bla			blackfoot
blb	Bilua	blb					
blc	Bella Coola	blc					
bld	Bolango	bld					
ble	Balanta-Kentohe	ble					
blf	Buol	blf					
blg	Balau	blg					
blh	Kuwaa	blh					
bli	Bolia	bli					
blj	Bolongan	blj					
blk	Pa'o Karen	blk					
bll	Biloxi	bll					
blm	Beli (Sudan)	blm					
bln	Southern Catanduanes Bikol	bln					
blo	Anii	blo					
blp	Blablanga	blp					
blq	Baluan-Pam	blq					
blr	Blang	blr					
bls	Balaesang	bls					
blt	Tai Dam	blt					
blv	Bolo	blv					
blw	Balangao	blw					
blx	Mag-Indi Ayta	blx					
bly	Notre	bly					
blz	Balantak	blz					
bma	Lame	bma					
bmb	Bembe	bmb					
bmc	Biem	bmc					
bmd	Baga Manduri	bmd					
bme	Limassa	bme					
bmf	Bom	bmf					
bmg	Bamwe	bmg					
bmh	Kein	bmh					
bmi	Bagirmi	bmi					
bmj	Bote-Majhi	bmj					
bmk	Ghayavi	bmk					
bml	Bomboli	bml					
bmm	Northern Betsimisaraka Malagasy	bmm					
bmn	Bina (Papua New Guinea)	bmn					
bmo	Bambalang	bmo					
bmp	Bulgebi	bmp					
bmq	Bomu	bmq					
bmr	Muinane	bmr					
bms	Bilma Kanuri	bms					
bmt	Biao Mon	bmt					
bmu	Somba-Siawari	bmu					
bmv	Bum	bmv					
bmw	Bomwali	bmw					
bmx	Baimak	bmx					
bmy	Bemba (Democratic Republic of Congo)	bmy					
bmz	Baramu	bmz					
bna	Bonerate	bna					
bnb	Bookan	bnb					
bnc	Bontok	bnc					
bnd	Banda (Indonesia)	bnd					
bne	Bintauna	bne					
bnf	Masiwang	bnf					
bng	Benga	bng					
bni	Bangi	bni					
bnj	Eastern Tawbuid	bnj					
bnk	Bierebo	bnk					
bnl	Boon	bnl					
bnm	Batanga	bnm					
bnn	Bunun	bnn					
bno	Bantoanon	bno					
bnp	Bola	bnp					
bnq	Bantik	bnq					
bnr	Butmas-Tur	bnr					
bns	Bundeli	bns					
bnu	Bentong	bnu					
bnv	Bonerif	bnv					
bnw	Bisis	bnw					
bnx	Bangubangu	bnx					
bny	Bintulu	bny					
bnz	Beezen	bnz					
boa	Bora	boa					
bob	Aweer	bob					
bod	Tibetan	bod	tib	bod	bo	tib;bo	tibétain
boe	Mundabli	boe					
bof	Bolon	bof					
bog	Bamako Sign Language	bog					
boh	Boma	boh					
boi	Barbareño	boi					
boj	Anjam	boj					
bok	Bonjo	bok					
bol	Bole	bol					
bom	Berom	bom					
bon	Bine	bon					
boo	Tiemacèwè Bozo	boo					
bop	Bonkiman	bop					
boq	Bogaya	boq					
bor	Borôro	bor					
bos	Bosnian	bos	bos	bos	bs	bs	Bosniakisch;bosniaque;Bosnisch
bot	Bongo	bot					
bou	Bondei	bou					
bov	Tuwuli	bov					
bow	Rema	bow					
box	Buamu	box					
boy	Bodo (Central African Republic)	boy					
boz	Tiéyaxo Bozo	boz					
bpa	Dakaka	bpa					
bpb	Barbacoas	bpb					
bpd	Banda-Banda	bpd					
bpg	Bonggo	bpg					
bph	Botlikh	bph					
bpi	Bagupi	bpi					
bpj	Binji	bpj					
bpk	Orowe	bpk					
bpl	Broome Pearling Lugger Pidgin	bpl					
bpm	Biyom	bpm					
bpn	Dzao Min	bpn					
bpo	Anasi	bpo					
bpp	Kaure	bpp					
bpq	Banda Malay	bpq					
bpr	Koronadal Blaan	bpr					
bps	Sarangani Blaan	bps					
bpt	Barrow Point	bpt					
bpu	Bongu	bpu					
bpv	Bian Marind	bpv					
bpw	Bo (Papua New Guinea)	bpw					
bpx	Palya Bareli	bpx					
bpy	Bishnupriya	bpy					
bpz	Bilba	bpz					
bqa	Tchumbuli	bqa					
bqb	Bagusa	bqb					
bqc	Boko (Benin)	bqc					
bqd	Bung	bqd					
bqf	Baga Kaloum	bqf					
bqg	Bago-Kusuntu	bqg					
bqh	Baima	bqh					
bqi	Bakhtiari	bqi					
bqj	Bandial	bqj					
bqk	Banda-Mbrès	bqk					
bql	Bilakura	bql					
bqm	Wumboko	bqm					
bqn	Bulgarian Sign Language	bqn					
bqo	Balo	bqo					
bqp	Busa	bqp					
bqq	Biritai	bqq					
bqr	Burusu	bqr					
bqs	Bosngun	bqs					
bqt	Bamukumbit	bqt					
bqu	Boguru	bqu					
bqv	Koro Wachi	bqv					
bqw	Buru (Nigeria)	bqw					
bqx	Baangi	bqx					
bqy	Bengkala Sign Language	bqy					
bqz	Bakaka	bqz					
bra	Braj	bra	bra	bra			braj
brb	Lave	brb					
brc	Berbice Creole Dutch	brc					
brd	Baraamu	brd					
bre	Breton	bre	bre	bre	br	brt;br	Bretonisch;breton
brf	Bera	brf					
brg	Baure	brg					
brh	Brahui	brh					
bri	Mokpwe	bri					
brj	Bieria	brj					
brk	Birked	brk					
brl	Birwa	brl					
brm	Barambu	brm					
brn	Boruca	brn					
bro	Brokkat	bro					
brp	Barapasi	brp					
brq	Breri	brq					
brr	Birao	brr					
brs	Baras	brs					
brt	Bitare	brt					
bru	Eastern Bru	bru					
brv	Western Bru	brv					
brw	Bellari	brw					
brx	Bodo (India)	brx					
bry	Burui	bry					
brz	Bilbil	brz					
bsa	Abinomn	bsa					
bsb	Brunei Bisaya	bsb					
bsc	Bassari	bsc					
bse	Wushi	bse					
bsf	Bauchi	bsf					
bsg	Bashkardi	bsg					
bsh	Kati	bsh					
bsi	Bassossi	bsi					
bsj	Bangwinji	bsj					
bsk	Burushaski	bsk					
bsl	Basa-Gumna	bsl					
bsm	Busami	bsm					
bsn	Barasana-Eduria	bsn					
bso	Buso	bso					
bsp	Baga Sitemu	bsp					
bsq	Bassa	bsq					
bsr	Bassa-Kontagora	bsr					
bss	Akoose	bss					
bst	Basketo	bst					
bsu	Bahonsuai	bsu					
bsv	Baga Sobané	bsv					
bsw	Baiso	bsw					
bsx	Yangkam	bsx					
bsy	Sabah Bisaya	bsy					
bta	Bata	bta					
btc	Bati (Cameroon)	btc					
btd	Batak Dairi	btd					
bte	Gamo-Ningi	bte					
btf	Birgit	btf					
btg	Gagnoa Bété	btg					
bth	Biatah Bidayuh	bth					
bti	Burate	bti					
btj	Bacanese Malay	btj					
btl	Bhatola	btl					
btm	Batak Mandailing	btm					
btn	Ratagnon	btn					
bto	Rinconada Bikol	bto					
btp	Budibud	btp					
btq	Batek	btq					
btr	Baetora	btr					
bts	Batak Simalungun	bts					
btt	Bete-Bendi	btt					
btu	Batu	btu					
btv	Bateri	btv					
btw	Butuanon	btw					
btx	Batak Karo	btx					
bty	Bobot	bty					
btz	Batak Alas-Kluet	btz					
bua	Buriat	bua	bua	bua			bouriate;Burjatisch
bub	Bua	bub					
buc	Bushi	buc					
bud	Ntcham	bud					
bue	Beothuk	bue					
buf	Bushoong	buf					
bug	Buginese	bug	bug	bug			Buginesisch;bugi
buh	Younuo Bunu	buh					
bui	Bongili	bui					
buj	Basa-Gurmana	buj					
buk	Bugawac	buk					
bul	Bulgarian	bul	bul	bul	bg	bg	bulgare;Bulgarisch
bum	Bulu (Cameroon)	bum					
bun	Sherbro	bun					
buo	Terei	buo					
bup	Busoa	bup					
buq	Brem	buq					
bus	Bokobaru	bus					
but	Bungain	but					
buu	Budu	buu					
buv	Bun	buv					
buw	Bubi	buw					
bux	Boghom	bux					
buy	Bullom So	buy					
buz	Bukwen	buz					
bva	Barein	bva					
bvb	Bube	bvb					
bvc	Baelelea	bvc					
bvd	Baeggu	bvd					
bve	Berau Malay	bve					
bvf	Boor	bvf					
bvg	Bonkeng	bvg					
bvh	Bure	bvh					
bvi	Belanda Viri	bvi					
bvj	Baan	bvj					
bvk	Bukat	bvk					
bvl	Bolivian Sign Language	bvl					
bvm	Bamunka	bvm					
bvn	Buna	bvn					
bvo	Bolgo	bvo					
bvq	Birri	bvq					
bvr	Burarra	bvr					
bvt	Bati (Indonesia)	bvt					
bvu	Bukit Malay	bvu					
bvv	Baniva	bvv					
bvw	Boga	bvw					
bvx	Dibole	bvx					
bvy	Baybayanon	bvy					
bvz	Bauzi	bvz					
bwa	Bwatoo	bwa					
bwb	Namosi-Naitasiri-Serua	bwb					
bwc	Bwile	bwc					
bwd	Bwaidoka	bwd					
bwe	Bwe Karen	bwe					
bwf	Boselewa	bwf					
bwg	Barwe	bwg					
bwh	Bishuo	bwh					
bwi	Baniwa	bwi					
bwj	Láá Láá Bwamu	bwj					
bwk	Bauwaki	bwk					
bwl	Bwela	bwl					
bwm	Biwat	bwm					
bwn	Wunai Bunu	bwn					
bwo	Boro (Ethiopia)	bwo					
bwp	Mandobo Bawah	bwp					
bwq	Southern Bobo Madaré	bwq					
bwr	Bura-Pabir	bwr					
bws	Bomboma	bws					
bwt	Bafaw-Balong	bwt					
bwu	Buli (Ghana)	bwu					
bww	Bwa	bww					
bwx	Bu-Nao Bunu	bwx					
bwy	Cwi Bwamu	bwy					
bwz	Bwisi	bwz					
bxa	Bauro	bxa					
bxb	Belanda Bor	bxb					
bxc	Molengue	bxc					
bxd	Pela	bxd					
bxe	Birale	bxe					
bxf	Bilur	bxf					
bxg	Bangala	bxg					
bxh	Buhutu	bxh					
bxi	Pirlatapa	bxi					
bxj	Bayungu	bxj					
bxk	Bukusu	bxk					
bxl	Jalkunan	bxl					
bxm	Mongolia Buriat	bxm					
bxn	Burduna	bxn					
bxo	Barikanchi	bxo					
bxp	Bebil	bxp					
bxq	Beele	bxq					
bxr	Russia Buriat	bxr					Buryat
bxs	Busam	bxs					
bxu	China Buriat	bxu					
bxv	Berakou	bxv					
bxw	Bankagooma	bxw					
bxx	Borna (Democratic Republic of Congo)	bxx					
bxz	Binahari	bxz					
bya	Batak	bya					
byb	Bikya	byb					
byc	Ubaghara	byc					
byd	Benyadu'	byd					
bye	Pouye	bye					
byf	Bete	byf					
byg	Baygo	byg					
byh	Bhujel	byh					
byi	Buyu	byi					
byj	Bina (Nigeria)	byj					
byk	Biao	byk					
byl	Bayono	byl					
bym	Bidyara	bym					
byn	Bilin	byn	byn	byn			blin;bilen;Blin
byo	Biyo	byo					
byp	Bumaji	byp					
byq	Basay	byq					
byr	Baruya	byr					
bys	Burak	bys					
byt	Berti	byt					
byv	Medumba	byv					
byw	Belhariya	byw					
byx	Qaqet	byx					
byy	Buya	byy					
byz	Banaro	byz					
bza	Bandi	bza					
bzb	Andio	bzb					
bzc	Southern Betsimisaraka Malagasy	bzc					
bzd	Bribri	bzd					
bze	Jenaama Bozo	bze					
bzf	Boikin	bzf					
bzg	Babuza	bzg					
bzh	Mapos Buang	bzh					
bzi	Bisu	bzi					
bzj	Belize Kriol English	bzj					
bzk	Nicaragua Creole English	bzk					
bzl	Boano (Sulawesi)	bzl					
bzm	Bolondo	bzm					
bzn	Boano (Maluku)	bzn					
bzo	Bozaba	bzo					
bzp	Kemberano	bzp					
bzq	Buli (Indonesia)	bzq					
bzr	Biri	bzr					
bzs	Brazilian Sign Language	bzs					
bzt	Brithenig	bzt					
bzu	Burmeso	bzu					
bzv	Bebe	bzv					
bzw	Basa (Nigeria)	bzw					
bzx	Kɛlɛngaxo Bozo	bzx					
bzy	Obanliku	bzy					
bzz	Evant	bzz					
caa	Chortí	caa					Ch'orti'
cab	Garifuna	cab					
cac	Chuj	cac					
cad	Caddo	cad	cad	cad			caddo
cae	Lehar	cae					
caf	Southern Carrier	caf					
cag	Nivaclé	cag					
cah	Cahuarano	cah					
caj	Chané	caj					
cak	Kaqchikel	cak					
cal	Carolinian	cal					
cam	Cemuhî	cam					
can	Chambri	can					
cao	Chácobo	cao					
cap	Chipaya	cap					
caq	Car Nicobarese	caq					
car	Galibi Carib	car	car	car			galibi;karib;carib
cas	Tsimané	cas					
cat	Catalan	cat	cat	cat	ca	ca	valencien;Katalanisch;catalan;Valencian
cav	Cavineña	cav					
caw	Callawalla	caw					
cax	Chiquitano	cax					
cay	Cayuga	cay					
caz	Canichana	caz					
cbb	Cabiyarí	cbb					
cbc	Carapana	cbc					
cbd	Carijona	cbd					
cbe	Chipiajes	cbe					
cbg	Chimila	cbg					
cbh	Cagua	cbh					
cbi	Chachi	cbi					
cbj	Ede Cabe	cbj					
cbk	Chavacano	cbk					
cbl	Bualkhaw Chin	cbl					
cbn	Nyahkur	cbn					
cbo	Izora	cbo					
cbr	Cashibo-Cacataibo	cbr					
cbs	Cashinahua	cbs					
cbt	Chayahuita	cbt					
cbu	Candoshi-Shapra	cbu					
cbv	Cacua	cbv					
cbw	Kinabalian	cbw					
cby	Carabayo	cby					
cca	Cauca	cca					
ccc	Chamicuro	ccc					
ccd	Cafundo Creole	ccd					
cce	Chopi	cce					
ccg	Samba Daka	ccg					
cch	Atsam	cch					
ccj	Kasanga	ccj					
ccl	Cutchi-Swahili	ccl					
ccm	Malaccan Creole Malay	ccm					
cco	Comaltepec Chinantec	cco					
ccp	Chakma	ccp					
ccr	Cacaopera	ccr					
cda	Choni	cda					
cde	Chenchu	cde					
cdf	Chiru	cdf					
cdg	Chamari	cdg					
cdh	Chambeali	cdh					
cdi	Chodri	cdi					
cdj	Churahi	cdj					
cdm	Chepang	cdm					
cdn	Chaudangsi	cdn					
cdo	Min Dong Chinese	cdo					Min Dong
cdr	Cinda-Regi-Tiyal	cdr					
cds	Chadian Sign Language	cds					
cdy	Chadong	cdy					
cdz	Koda	cdz					
cea	Lower Chehalis	cea					
ceb	Cebuano	ceb	ceb	ceb			cebuano
ceg	Chamacoco	ceg					
cek	Eastern Khumi Chin	cek					
cen	Cen	cen					
ces	Czech	ces	cze	ces	cs	cze;cs	Tschechisch;tchèque
cet	Centúúm	cet					
cfa	Dijim-Bwilim	cfa					
cfd	Cara	cfd					
cfg	Como Karim	cfg					
cfm	Falam Chin	cfm					
cga	Changriwa	cga					
cgc	Kagayanen	cgc					
cgg	Chiga	cgg					
cgk	Chocangacakha	cgk					
cha	Chamorro	cha	cha	cha	ch	ch	chamorro
chb	Chibcha	chb	chb	chb			chibcha
chc	Catawba	chc					
chd	Highland Oaxaca Chontal	chd					
che	Chechen	che	che	che	ce	ce	Tschetschenisch;tchétchène
chf	Tabasco Chontal	chf					
chg	Chagatai	chg	chg	chg			djaghataï
chh	Chinook	chh					
chj	Ojitlán Chinantec	chj					
chk	Chuukese	chk	chk	chk			Trukese;chuuk
chl	Cahuilla	chl					
chm	Mari (Russia)	chm	chm	chm			mari;Mari;Marijisch
chn	Chinook jargon	chn	chn	chn			chinook, jargon
cho	Choctaw	cho	cho	cho			choctaw
chp	Chipewyan	chp	chp	chp			chipewyan;Dene Suline
chq	Quiotepec Chinantec	chq					
chr	Cherokee	chr	chr	chr			Tscherokesisch;cherokee
cht	Cholón	cht					
chu	Church Slavic	chu	chu	chu	cu	cu	vieux slave;slavon liturgique;Church Slavonic;Old Bulgarian;Old Church Slavonic;vieux bulgare;slavon d'église;Old Slavonic;Altslawisch (Kirchenslawisch)
chv	Chuvash	chv	chv	chv	cv	cv	tchouvache;Tschuwaschisch
chw	Chuwabu	chw					
chx	Chantyal	chx					
chy	Cheyenne	chy	chy	chy			cheyenne
chz	Ozumacín Chinantec	chz					
cia	Cia-Cia	cia					
cib	Ci Gbe	cib					
cic	Chickasaw	cic					
cid	Chimariko	cid					
cie	Cineni	cie					
cih	Chinali	cih					
cik	Chitkuli Kinnauri	cik					
cim	Cimbrian	cim					
cin	Cinta Larga	cin					
cip	Chiapanec	cip					
cir	Tiri	cir					
ciw	Chippewa	ciw					
ciy	Chaima	ciy					
cja	Western Cham	cja					Cham
cje	Chru	cje					
cjh	Upper Chehalis	cjh					
cji	Chamalal	cji					
cjk	Chokwe	cjk					
cjm	Eastern Cham	cjm					
cjn	Chenapian	cjn					
cjo	Ashéninka Pajonal	cjo					
cjp	Cabécar	cjp					
cjs	Shor	cjs					
cjv	Chuave	cjv					
cjy	Jinyu Chinese	cjy					Jinyu
ckb	Central Kurdish	ckb					
ckh	Chak	ckh					
ckl	Cibak	ckl					
ckn	Kaang Chin	ckn					
cko	Anufo	cko					
ckq	Kajakse	ckq					
ckr	Kairak	ckr					
cks	Tayo	cks					
ckt	Chukot	ckt					Tschuktschisch
cku	Koasati	cku					
ckv	Kavalan	ckv					
ckx	Caka	ckx					
cky	Cakfem-Mushere	cky					
ckz	Cakchiquel-Quiché Mixed Language	ckz					
cla	Ron	cla					
clc	Chilcotin	clc					
cld	Chaldean Neo-Aramaic	cld					
cle	Lealao Chinantec	cle					
clh	Chilisso	clh					
cli	Chakali	cli					
clj	Laitu Chin	clj					
clk	Idu-Mishmi	clk					
cll	Chala	cll					
clm	Clallam	clm					
clo	Lowland Oaxaca Chontal	clo					
clt	Lautu Chin	clt					
clu	Caluyanun	clu					
clw	Chulym	clw					
cly	Eastern Highland Chatino	cly					
cma	Maa	cma					
cme	Cerma	cme					
cmg	Classical Mongolian	cmg					
cmi	Emberá-Chamí	cmi					
cml	Campalagian	cml					
cmm	Michigamea	cmm					
cmn	Mandarin Chinese	cmn					Chinese (Mandarin);Mandarin
cmo	Central Mnong	cmo					
cmr	Mro-Khimi Chin	cmr					
cms	Messapic	cms					
cmt	Camtho	cmt					
cna	Changthang	cna					
cnb	Chinbon Chin	cnb					
cnc	Côông	cnc					
cng	Northern Qiang	cng					
cnh	Haka Chin	cnh					
cni	Asháninka	cni					
cnk	Khumi Chin	cnk					
cnl	Lalana Chinantec	cnl					
cno	Con	cno					
cns	Central Asmat	cns					
cnt	Tepetotutla Chinantec	cnt					
cnu	Chenoua	cnu					
cnw	Ngawn Chin	cnw					
cnx	Middle Cornish	cnx					
coa	Cocos Islands Malay	coa					
cob	Chicomuceltec	cob					
coc	Cocopa	coc					
cod	Cocama-Cocamilla	cod					
coe	Koreguaje	coe					
cof	Colorado	cof					
cog	Chong	cog					
coh	Chonyi-Dzihana-Kauma	coh					
coj	Cochimi	coj					
cok	Santa Teresa Cora	cok					
col	Columbia-Wenatchi	col					
com	Comanche	com					
con	Cofán	con					
coo	Comox	coo					
cop	Coptic	cop	cop	cop			copte
coq	Coquille	coq					
cor	Cornish	cor	cor	cor	kw	kw	Kornisch;cornique
cos	Corsican	cos	cos	cos	co	co	corse;Korsisch
cot	Caquinte	cot					
cou	Wamey	cou					
cov	Cao Miao	cov					
cow	Cowlitz	cow					
cox	Nanti	cox					
coy	Coyaima	coy					
coz	Chochotec	coz					
cpa	Palantla Chinantec	cpa					
cpb	Ucayali-Yurúa Ashéninka	cpb					
cpc	Ajyíninka Apurucayali	cpc					
cpg	Cappadocian Greek	cpg					
cpi	Chinese Pidgin English	cpi					
cpn	Cherepon	cpn					
cps	Capiznon	cps					
cpu	Pichis Ashéninka	cpu					
cpx	Pu-Xian Chinese	cpx					Pu-Xian
cpy	South Ucayali Ashéninka	cpy					
cqd	Chuanqiandian Cluster Miao	cqd					
cqu	Chilean Quechua	cqu					
cra	Chara	cra					
crb	Island Carib	crb					
crc	Lonwolwol	crc					
crd	Coeur d'Alene	crd					
cre	Cree	cre	cre	cre	cr	cr	Cree / Cri / Kri;cree
crf	Caramanta	crf					
crg	Michif	crg					
crh	Crimean Tatar	crh	crh	crh			Crimean Turkish;Krimtatarisch;tatar de Crimé
cri	Sãotomense	cri					
crj	Southern East Cree	crj					
crk	Plains Cree	crk					
crl	Northern East Cree	crl					
crm	Moose Cree	crm					
crn	El Nayar Cora	crn					
cro	Crow	cro					
crq	Iyo'wujwa Chorote	crq					
crr	Carolina Algonquian	crr					
crs	Seselwa Creole French	crs					
crt	Iyojwa'ja Chorote	crt					
crv	Chaura	crv					
crw	Chrau	crw					
crx	Carrier	crx					
cry	Cori	cry					
crz	Cruzeño	crz					
csa	Chiltepec Chinantec	csa					
csb	Kashubian	csb	csb	csb			Kaschubisch;kachoube
csc	Catalan Sign Language	csc					
csd	Chiangmai Sign Language	csd					
cse	Czech Sign Language	cse					
csf	Cuba Sign Language	csf					
csg	Chilean Sign Language	csg					
csh	Asho Chin	csh					
csi	Coast Miwok	csi					
csk	Jola-Kasa	csk					
csl	Chinese Sign Language	csl					
csm	Central Sierra Miwok	csm					
csn	Colombian Sign Language	csn					
cso	Sochiapam Chinantec	cso					
csq	Croatia Sign Language	csq					
csr	Costa Rican Sign Language	csr					
css	Southern Ohlone	css					
cst	Northern Ohlone	cst					
csv	Sumtu Chin	csv					
csw	Swampy Cree	csw					
csy	Siyin Chin	csy					
csz	Coos	csz					
cta	Tataltepec Chatino	cta					
ctc	Chetco	ctc					
ctd	Tedim Chin	ctd					
cte	Tepinapa Chinantec	cte					
ctg	Chittagonian	ctg					
cth	Thaiphum Chin	cth					
ctl	Tlacoatzintepec Chinantec	ctl					
ctm	Chitimacha	ctm					
ctn	Chhintange	ctn					
cto	Emberá-Catío	cto					
ctp	Western Highland Chatino	ctp					
cts	Northern Catanduanes Bikol	cts					
ctt	Wayanad Chetti	ctt					
ctu	Chol	ctu					
ctz	Zacatepec Chatino	ctz					
cua	Cua	cua					
cub	Cubeo	cub					
cuc	Usila Chinantec	cuc					
cug	Cung	cug					
cuh	Chuka	cuh					
cui	Cuiba	cui					
cuj	Mashco Piro	cuj					
cuk	San Blas Kuna	cuk					Kuna
cul	Culina	cul					
cum	Cumeral	cum					
cuo	Cumanagoto	cuo					
cup	Cupeño	cup					
cuq	Cun	cuq					
cur	Chhulung	cur					
cut	Teutila Cuicatec	cut					
cuu	Tai Ya	cuu					
cuv	Cuvok	cuv					
cuw	Chukwa	cuw					
cux	Tepeuxila Cuicatec	cux					
cvg	Chug	cvg					
cvn	Valle Nacional Chinantec	cvn					
cwa	Kabwa	cwa					
cwb	Maindo	cwb					
cwd	Woods Cree	cwd					
cwe	Kwere	cwe					
cwg	Chewong	cwg					
cwt	Kuwaataay	cwt					
cya	Nopala Chatino	cya					
cyb	Cayubaba	cyb					
cym	Welsh	cym	wel	cym	cy	cy;wel	gallois;Walisisch
cyo	Cuyonon	cyo					
czh	Huizhou Chinese	czh					Huizhou
czk	Knaanic	czk					
czn	Zenzontepec Chatino	czn					
czo	Min Zhong Chinese	czo					Min Zhong
czt	Zotung Chin	czt					
daa	Dangaléat	daa					
dac	Dambi	dac					
dad	Marik	dad					
dae	Duupa	dae					
daf	Dan	daf					
dag	Dagbani	dag					
dah	Gwahatike	dah					
dai	Day	dai					
daj	Dar Fur Daju	daj					
dak	Dakota	dak	dak	dak			dakota
dal	Dahalo	dal					
dam	Damakawa	dam					
dan	Danish	dan	dan	dan	da	da	danois;Dänisch
dao	Daai Chin	dao					
daq	Dandami Maria	daq					
dar	Dargwa	dar	dar	dar			dargwa
das	Daho-Doo	das					
dau	Dar Sila Daju	dau					
dav	Taita	dav					
daw	Davawenyo	daw					
dax	Dayi	dax					
daz	Dao	daz					
dba	Bangi Me	dba					
dbb	Deno	dbb					
dbd	Dadiya	dbd					
dbe	Dabe	dbe					
dbf	Edopi	dbf					
dbg	Dogul Dom Dogon	dbg					
dbi	Doka	dbi					
dbj	Ida'an	dbj					
dbl	Dyirbal	dbl					
dbm	Duguri	dbm					
dbn	Duriankere	dbn					
dbo	Dulbu	dbo					
dbp	Duwai	dbp					
dbq	Daba	dbq					
dbr	Dabarre	dbr					
dbt	Ben Tey Dogon	dbt					
dbu	Bondum Dom Dogon	dbu					
dbv	Dungu	dbv					
dbw	Bankan Tey Dogon	dbw					
dby	Dibiyaso	dby					
dcc	Deccan	dcc					
dcr	Negerhollands	dcr					
dda	Dadi Dadi	dda					
ddd	Dongotono	ddd					
dde	Doondo	dde					
ddg	Fataluku	ddg					
ddi	West Goodenough	ddi					
ddj	Jaru	ddj					
ddn	Dendi (Benin)	ddn					
ddo	Dido	ddo					
ddr	Dhudhuroa	ddr					
dds	Donno So Dogon	dds					
ddw	Dawera-Daweloor	ddw					
dec	Dagik	dec					
ded	Dedua	ded					
dee	Dewoin	dee					
def	Dezfuli	def					
deg	Degema	deg					
deh	Dehwari	deh					
dei	Demisa	dei					
dek	Dek	dek					
del	Delaware	del	del	del			delaware
dem	Dem	dem					
den	Slave (Athapascan)	den	den	den			esclave (athapascan)
dep	Pidgin Delaware	dep					
deq	Dendi (Central African Republic)	deq					
der	Deori	der					
des	Desano	des					
deu	German	deu	ger	deu	de	de;ger	allemand;Deutsch
dev	Domung	dev					
dez	Dengese	dez					
dga	Southern Dagaare	dga					
dgb	Bunoge Dogon	dgb					
dgc	Casiguran Dumagat Agta	dgc					
dgd	Dagaari Dioula	dgd					
dge	Degenan	dge					
dgg	Doga	dgg					
dgh	Dghwede	dgh					
dgi	Northern Dagara	dgi					
dgk	Dagba	dgk					
dgl	Andaandi	dgl					
dgn	Dagoman	dgn					
dgo	Dogri (individual language)	dgo					
dgr	Dogrib	dgr	dgr	dgr			dogrib
dgs	Dogoso	dgs					
dgt	Ndrag'ngith	dgt					
dgu	Degaru	dgu					
dgw	Daungwurrung	dgw					
dgx	Doghoro	dgx					
dgz	Daga	dgz					
dhd	Dhundari	dhd					
dhg	Dhangu	dhg					
dhi	Dhimal	dhi					
dhl	Dhalandji	dhl					
dhm	Zemba	dhm					
dhn	Dhanki	dhn					
dho	Dhodia	dho					
dhr	Dhargari	dhr					
dhs	Dhaiso	dhs					
dhu	Dhurga	dhu					
dhv	Dehu	dhv					
dhw	Dhanwar (Nepal)	dhw					
dia	Dia	dia					
dib	South Central Dinka	dib					
dic	Lakota Dida	dic					
did	Didinga	did					
dif	Dieri	dif					
dig	Digo	dig					
dih	Kumiai	dih					
dii	Dimbong	dii					
dij	Dai	dij					
dik	Southwestern Dinka	dik					
dil	Dilling	dil					
dim	Dime	dim					
din	Dinka	din	din	din			dinka
dio	Dibo	dio					
dip	Northeastern Dinka	dip					
diq	Dimli (individual language)	diq					
dir	Dirim	dir					
dis	Dimasa	dis					
dit	Dirari	dit					
diu	Diriku	diu					Diudish
div	Dhivehi	div	div	div	dv	dv	maldivien;Divehi;Maldivian;Dhivehi/Maledivisch;Maledivisch/Dhivehi
diw	Northwestern Dinka	diw					
dix	Dixon Reef	dix					
diy	Diuwe	diy					
diz	Ding	diz					
dja	Djadjawurrung	dja					
djb	Djinba	djb					
djc	Dar Daju Daju	djc					
djd	Djamindjung	djd					
dje	Zarma	dje					
djf	Djangun	djf					
dji	Djinang	dji					
djj	Djeebbana	djj					
djk	Eastern Maroon Creole	djk					
djl	Djiwarli	djl					
djm	Jamsay Dogon	djm					
djn	Djauan	djn					
djo	Jangkang	djo					
djr	Djambarrpuyngu	djr					
dju	Kapriman	dju					
djw	Djawi	djw					
dka	Dakpakha	dka					
dkk	Dakka	dkk					
dkr	Kuijau	dkr					
dks	Southeastern Dinka	dks					
dkx	Mazagway	dkx					
dlg	Dolgan	dlg					
dlm	Dalmatian	dlm					
dln	Darlong	dln					
dma	Duma	dma					
dmb	Mombo Dogon	dmb					
dmc	Dimir	dmc					
dmd	Madhi Madhi	dmd					
dme	Dugwor	dme					
dmg	Upper Kinabatangan	dmg					
dmk	Domaaki	dmk					
dml	Dameli	dml					
dmm	Dama	dmm					
dmo	Kemedzung	dmo					
dmr	East Damar	dmr					
dms	Dampelas	dms					
dmu	Dubu	dmu					
dmv	Dumpas	dmv					
dmx	Dema	dmx					
dmy	Demta	dmy					
dna	Upper Grand Valley Dani	dna					
dnd	Daonda	dnd					
dne	Ndendeule	dne					
dng	Dungan	dng					Dunganisch
dni	Lower Grand Valley Dani	dni					
dnk	Dengka	dnk					
dnn	Dzùùngoo	dnn					
dnr	Danaru	dnr					
dnt	Mid Grand Valley Dani	dnt					
dnu	Danau	dnu					
dnv	Danu	dnv					
dnw	Western Dani	dnw					
dny	Dení	dny					
doa	Dom	doa					
dob	Dobu	dob					
doc	Northern Dong	doc					
doe	Doe	doe					
dof	Domu	dof					
doh	Dong	doh					
doi	Dogri (macrolanguage)	doi	doi	doi			dogri;Dogri
dok	Dondo	dok					
dol	Doso	dol					
don	Toura (Papua New Guinea)	don					
doo	Dongo	doo					
dop	Lukpa	dop					
doq	Dominican Sign Language	doq					
dor	Dori'o	dor					
dos	Dogosé	dos					
dot	Dass	dot					
dov	Dombe	dov					
dow	Doyayo	dow					
dox	Bussa	dox					
doy	Dompo	doy					
doz	Dorze	doz					
dpp	Papar	dpp					
drb	Dair	drb					
drc	Minderico	drc					
drd	Darmiya	drd					
dre	Dolpo	dre					
drg	Rungus	drg					
dri	C'lela	dri					
drl	Paakantyi	drl					Darling
drn	West Damar	drn					
dro	Daro-Matu Melanau	dro					
drq	Dura	drq					
drr	Dororo	drr					
drs	Gedeo	drs					
drt	Drents	drt					
dru	Rukai	dru					
dry	Darai	dry					
dsb	Lower Sorbian	dsb	dsb	dsb			Niedersorbisch;bas-sorabe;Nieder-Sorbisch
dse	Dutch Sign Language	dse					
dsh	Daasanach	dsh					
dsi	Disa	dsi					
dsl	Danish Sign Language	dsl					
dsn	Dusner	dsn					
dso	Desiya	dso					
dsq	Tadaksahak	dsq					
dta	Daur	dta					
dtb	Labuk-Kinabatangan Kadazan	dtb					
dtd	Ditidaht	dtd					
dth	Adithinngithigh	dth					
dti	Ana Tinga Dogon	dti					
dtk	Tene Kan Dogon	dtk					
dtm	Tomo Kan Dogon	dtm					
dto	Tommo So Dogon	dto					
dtp	Central Dusun	dtp					
dtr	Lotud	dtr					
dts	Toro So Dogon	dts					
dtt	Toro Tegu Dogon	dtt					
dtu	Tebul Ure Dogon	dtu					
dty	Dotyali	dty					
dua	Duala	dua	dua	dua			douala
dub	Dubli	dub					
duc	Duna	duc					
dud	Hun-Saare	dud					
due	Umiray Dumaget Agta	due					
duf	Dumbea	duf					
dug	Duruma	dug					
duh	Dungra Bhil	duh					
dui	Dumun	dui					
duj	Dhuwal	duj					
duk	Uyajitaya	duk					
dul	Alabat Island Agta	dul					
dum	Middle Dutch	dum	dum	dum			néerlandais moyen (ca. 1050-1350);Mittelniederländisch;Dutch, Middle (ca.1050-1350);Middle Dutch (ca. 1050-1350)
dun	Dusun Deyah	dun					
duo	Dupaninan Agta	duo					
dup	Duano	dup					
duq	Dusun Malang	duq					
dur	Dii	dur					
dus	Dumi	dus					
duu	Drung	duu					
duv	Duvle	duv					
duw	Dusun Witu	duw					
dux	Duungooma	dux					
duy	Dicamay Agta	duy					
duz	Duli	duz					
dva	Duau	dva					
dwa	Diri	dwa					
dwr	Dawro	dwr					
dws	Dutton World Speedwords	dws					
dww	Dawawa	dww					
dya	Dyan	dya					
dyb	Dyaberdyaber	dyb					
dyd	Dyugun	dyd					
dyg	Villa Viciosa Agta	dyg					
dyi	Djimini Senoufo	dyi					
dym	Yanda Dom Dogon	dym					
dyn	Dyangadi	dyn					
dyo	Jola-Fonyi	dyo					
dyu	Dyula	dyu	dyu	dyu			dioula
dyy	Dyaabugay	dyy					
dza	Tunzu	dza					
dzd	Daza	dzd					
dzg	Dazaga	dzg					
dzl	Dzalakha	dzl					
dzn	Dzando	dzn					
dzo	Dzongkha	dzo	dzo	dzo	dz	dz	dzongkha;Dzongkha/Bhutanisch
ebg	Ebughu	ebg					
ebk	Eastern Bontok	ebk					
ebo	Teke-Ebo	ebo					
ebr	Ebrié	ebr					
ebu	Embu	ebu					
ecr	Eteocretan	ecr					
ecs	Ecuadorian Sign Language	ecs					
ecy	Eteocypriot	ecy					
eee	E	eee					
efa	Efai	efa					
efe	Efe	efe					
efi	Efik	efi	efi	efi			efik
ega	Ega	ega					
egl	Emilian	egl					
ego	Eggon	ego					
egy	Egyptian	egy	egy	egy			égyptien;Egyptian (Ancient);Ägyptisch
ehu	Ehueun	ehu					
eip	Eipomek	eip					
eit	Eitiep	eit					
eiv	Askopan	eiv					
eja	Ejamat	eja					
eka	Ekajuk	eka	eka	eka			ekajuk
eke	Ekit	eke					
ekg	Ekari	ekg					
eki	Eki	eki					
ekk	Standard Estonian	ekk					
ekl	Kol (Bangladesh)	ekl					
ekm	Elip	ekm					
eko	Koti	eko					
ekp	Ekpeye	ekp					
ekr	Yace	ekr					
eky	Eastern Kayah	eky					
ele	Elepi	ele					
elh	El Hugeirat	elh					
eli	Nding	eli					
elk	Elkei	elk					
ell	Greek	ell	gre	ell	el	gre;el;grk	Griechisch (Neu-);Greek, Modern (1453-);Neugriechisch;Neugriechisch (Dimotiki);grec moderne (après 1453);Neugriechisch (Kathareuusa);Modern Greek (1453-)
elm	Eleme	elm					
elo	El Molo	elo					
elu	Elu	elu					
elx	Elamite	elx	elx	elx			élamite
ema	Emai-Iuleha-Ora	ema					
emb	Embaloh	emb					
eme	Emerillon	eme					
emg	Eastern Meohang	emg					
emi	Mussau-Emira	emi					
emk	Eastern Maninkakan	emk					
emm	Mamulique	emm					
emn	Eman	emn					
emo	Emok	emo					
emp	Northern Emberá	emp					
ems	Pacific Gulf Yupik	ems					
emu	Eastern Muria	emu					
emw	Emplawas	emw					
emx	Erromintxela	emx					
emy	Epigraphic Mayan	emy					
ena	Apali	ena					
enb	Markweeta	enb					
enc	En	enc					
end	Ende	end					
enf	Forest Enets	enf					
eng	English	eng	eng	eng	en	en	Englisch;anglais
enh	Tundra Enets	enh					
enm	Middle English	enm	enm	enm			English, Middle (1100-1500);Middle English (1100-1500);anglais moyen (1100-1500)
enn	Engenni	enn					
eno	Enggano	eno					
enq	Enga	enq					
enr	Emumu	enr					
enu	Enu	enu					
env	Enwan (Edu State)	env					
enw	Enwan (Akwa Ibom State)	enw					
eot	Beti (Côte d'Ivoire)	eot					
epi	Epie	epi					
epo	Esperanto	epo	epo	epo	eo	eo	espéranto
era	Eravallan	era					
erg	Sie	erg					
erh	Eruwa	erh					
eri	Ogea	eri					
erk	South Efate	erk					
ero	Horpa	ero					
err	Erre	err					
ers	Ersu	ers					
ert	Eritai	ert					
erw	Erokwanas	erw					
ese	Ese Ejja	ese					
esh	Eshtehardi	esh					
esi	North Alaskan Inupiatun	esi					
esk	Northwest Alaska Inupiatun	esk					
esl	Egypt Sign Language	esl					
esm	Esuma	esm					
esn	Salvadoran Sign Language	esn					
eso	Estonian Sign Language	eso					
esq	Esselen	esq					
ess	Central Siberian Yupik	ess					
est	Estonian	est	est	est	et	et	estonien;Estnisch
esu	Central Yupik	esu					Yup'ik
etb	Etebi	etb					
etc	Etchemin	etc					
eth	Ethiopian Sign Language	eth					
etn	Eton (Vanuatu)	etn					
eto	Eton (Cameroon)	eto					
etr	Edolo	etr					
ets	Yekhee	ets					
ett	Etruscan	ett					
etu	Ejagham	etu					
etx	Eten	etx					
etz	Semimi	etz					
eus	Basque	eus	baq	eus	eu	baq;eu	basque;Baskisch
eve	Even	eve					
evh	Uvbie	evh					
evn	Evenki	evn					
ewe	Ewe	ewe	ewe	ewe	ee	ee	éwé
ewo	Ewondo	ewo	ewo	ewo			éwondo
ext	Extremaduran	ext					
eya	Eyak	eya					
eyo	Keiyo	eyo					
eze	Uzekwe	eze					
faa	Fasu	faa					
fab	Fa D'ambu	fab					
fad	Wagi	fad					
faf	Fagani	faf					
fag	Finongan	fag					
fah	Baissa Fali	fah					
fai	Faiwol	fai					
faj	Faita	faj					
fak	Fang (Cameroon)	fak					
fal	South Fali	fal					
fam	Fam	fam					
fan	Fang (Equatorial Guinea)	fan	fan	fan			fang;Fang
fao	Faroese	fao	fao	fao	fo	fo	Färingisch;féroïen;Färöisch
fap	Palor	fap					
far	Fataleka	far					
fas	Persian	fas	per	fas	fa	fa;per	Dari;Persisch;Farsi (Persisch);persan
fat	Fanti	fat	fat	fat			fanti
fau	Fayu	fau					
fax	Fala	fax					
fay	Southwestern Fars	fay					
faz	Northwestern Fars	faz					
fbl	West Albay Bikol	fbl					
fcs	Quebec Sign Language	fcs					
fer	Feroge	fer					
ffi	Foia Foia	ffi					
ffm	Maasina Fulfulde	ffm					
fgr	Fongoro	fgr					
fia	Nobiin	fia					
fie	Fyer	fie					
fij	Fijian	fij	fij	fij	fj	fj	fidjien;Fidschianisch;Fidschi
fil	Filipino	fil	fil	fil			pilipino;Pilipino;filipino
fin	Finnish	fin	fin	fin	fi	fi	finnois;Finnisch
fip	Fipa	fip					
fir	Firan	fir					
fit	Tornedalen Finnish	fit					Meänkieli
fiw	Fiwaga	fiw					
fkk	Kirya-Konzəl	fkk					
fkv	Kven Finnish	fkv					
fla	Kalispel-Pend d'Oreille	fla					
flh	Foau	flh					
fli	Fali	fli					
fll	North Fali	fll					
fln	Flinders Island	fln					
flr	Fuliiru	flr					
fly	Tsotsitaal	fly					
fmp	Fe'fe'	fmp					
fmu	Far Western Muria	fmu					
fng	Fanagalo	fng					
fni	Fania	fni					
fod	Foodo	fod					
foi	Foi	foi					
fom	Foma	fom					
fon	Fon	fon	fon	fon			fon;Fongbe
for	Fore	for					
fos	Siraya	fos					
fpe	Fernando Po Creole English	fpe					
fqs	Fas	fqs					
fra	French	fra	fre	fra	fr	fr;fre	français;Französisch
frc	Cajun French	frc					
frd	Fordata	frd					
frk	Frankish	frk					
frm	Middle French	frm	frm	frm			français moyen (1400-1600);French, Middle (ca.1400-1600);Middle French (ca. 1400-1600)
fro	Old French	fro	fro	fro			français ancien (842-ca.1400);Old French (842-ca. 1400);French, Old (842-ca.1400)
frp	Arpitan	frp					Franko-Provenzalisch;Arpitanisch
frq	Forak	frq					
frr	Northern Frisian	frr	frr	frr			frison septentrional
frs	Eastern Frisian	frs	frs	frs			frison oriental
frt	Fortsenal	frt					
fry	Western Frisian	fry	fry	fry	fy	fy	Nordfriesisch;Nord-Friesisch;Westfriesisch;Friesisch;West-Friesisch;West Frisian;frison occidental
fse	Finnish Sign Language	fse					
fsl	French Sign Language	fsl					
fss	Finland-Swedish Sign Language	fss					
fub	Adamawa Fulfulde	fub					
fuc	Pulaar	fuc					
fud	East Futuna	fud					
fue	Borgu Fulfulde	fue					
fuf	Pular	fuf					
fuh	Western Niger Fulfulde	fuh					
fui	Bagirmi Fulfulde	fui					
fuj	Ko	fuj					
ful	Fulah	ful	ful	ful	ff	ff	Fula;peul
fum	Fum	fum					
fun	Fulniô	fun					
fuq	Central-Eastern Niger Fulfulde	fuq					
fur	Friulian	fur	fur	fur			Friaulisch;Furlanisch;frioulan
fut	Futuna-Aniwa	fut					
fuu	Furu	fuu					
fuv	Nigerian Fulfulde	fuv					
fuy	Fuyug	fuy					
fvr	Fur	fvr					
fwa	Fwâi	fwa					
fwe	Fwe	fwe					
gaa	Ga	gaa	gaa	gaa			ga
gab	Gabri	gab					
gac	Mixed Great Andamanese	gac					
gad	Gaddang	gad					
gae	Guarequena	gae					
gaf	Gende	gaf					
gag	Gagauz	gag					Gagausisch
gah	Alekano	gah					
gai	Borei	gai					
gaj	Gadsup	gaj					
gak	Gamkonora	gak					
gal	Galoli	gal					
gam	Kandawo	gam					
gan	Gan Chinese	gan					Gan
gao	Gants	gao					
gap	Gal	gap					
gaq	Gata'	gaq					
gar	Galeya	gar					
gas	Adiwasi Garasia	gas					
gat	Kenati	gat					
gau	Mudhili Gadaba	gau					
gaw	Nobonob	gaw					
gax	Borana-Arsi-Guji Oromo	gax					
gay	Gayo	gay	gay	gay			gayo
gaz	West Central Oromo	gaz					
gba	Gbaya (Central African Republic)	gba	gba	gba			Gbaya;gbaya
gbb	Kaytetye	gbb					
gbd	Karadjeri	gbd					
gbe	Niksek	gbe					
gbf	Gaikundi	gbf					
gbg	Gbanziri	gbg					
gbh	Defi Gbe	gbh					
gbi	Galela	gbi					
gbj	Bodo Gadaba	gbj					
gbk	Gaddi	gbk					
gbl	Gamit	gbl					
gbm	Garhwali	gbm					
gbn	Mo'da	gbn					
gbo	Northern Grebo	gbo					
gbp	Gbaya-Bossangoa	gbp					
gbq	Gbaya-Bozoum	gbq					
gbr	Gbagyi	gbr					
gbs	Gbesi Gbe	gbs					
gbu	Gagadu	gbu					
gbv	Gbanu	gbv					
gbx	Eastern Xwla Gbe	gbx					
gby	Gbari	gby					
gbz	Zoroastrian Dari	gbz					
gcc	Mali	gcc					
gcd	Ganggalida	gcd					
gce	Galice	gce					
gcf	Guadeloupean Creole French	gcf					
gcl	Grenadian Creole English	gcl					
gcn	Gaina	gcn					
gcr	Guianese Creole French	gcr					
gct	Colonia Tovar German	gct					
gda	Gade Lohar	gda					
gdb	Pottangi Ollar Gadaba	gdb					
gdc	Gugu Badhun	gdc					
gdd	Gedaged	gdd					
gde	Gude	gde					
gdf	Guduf-Gava	gdf					
gdg	Ga'dang	gdg					
gdh	Gadjerawang	gdh					
gdi	Gundi	gdi					
gdj	Gurdjar	gdj					
gdk	Gadang	gdk					
gdl	Dirasha	gdl					
gdm	Laal	gdm					
gdn	Umanakaina	gdn					
gdo	Ghodoberi	gdo					
gdq	Mehri	gdq					
gdr	Wipi	gdr					
gds	Ghandruk Sign Language	gds					
gdu	Gudu	gdu					
gdx	Godwari	gdx					
gea	Geruma	gea					
geb	Kire	geb					
gec	Gboloo Grebo	gec					
ged	Gade	ged					
geg	Gengle	geg					
geh	Hutterite German	geh					
gei	Gebe	gei					
gej	Gen	gej					
gek	Yiwom	gek					
gel	ut-Ma'in	gel					
geq	Geme	geq					
ges	Geser-Gorom	ges					
gew	Gera	gew					
gex	Garre	gex					
gey	Enya	gey					
gez	Geez	gez	gez	gez			guèze
gfk	Patpatar	gfk					
gft	Gafat	gft					
gfx	Mangetti Dune !Xung	gfx					
gga	Gao	gga					
ggb	Gbii	ggb					
ggd	Gugadj	ggd					
gge	Guragone	gge					
ggg	Gurgula	ggg					
ggk	Kungarakany	ggk					
ggl	Ganglau	ggl					
ggn	Eastern Gurung	ggn					
ggo	Southern Gondi	ggo					
ggr	Aghu Tharnggalu	ggr					
ggt	Gitua	ggt					
ggu	Gagu	ggu					
ggw	Gogodala	ggw					
gha	Ghadamès	gha					
ghc	Hiberno-Scottish Gaelic	ghc					
ghe	Southern Ghale	ghe					
ghh	Northern Ghale	ghh					
ghk	Geko Karen	ghk					
ghl	Ghulfan	ghl					
ghn	Ghanongga	ghn					
gho	Ghomara	gho					
ghr	Ghera	ghr					
ghs	Guhu-Samane	ghs					
ght	Kuke	ght					
gia	Kitja	gia					
gib	Gibanawa	gib					
gic	Gail	gic					
gid	Gidar	gid					
gig	Goaria	gig					
gil	Gilbertese	gil	gil	gil			kiribati;Kiribatisch;Gilbertesisch
gim	Gimi (Eastern Highlands)	gim					
gin	Hinukh	gin					
gip	Gimi (West New Britain)	gip					
giq	Green Gelao	giq					
gir	Red Gelao	gir					
gis	North Giziga	gis					
git	Gitxsan	git					
giu	Mulao	giu					
giw	White Gelao	giw					
gix	Gilima	gix					
giy	Giyug	giy					
giz	South Giziga	giz					
gji	Geji	gji					
gjk	Kachi Koli	gjk					
gjn	Gonja	gjn					
gju	Gujari	gju					
gka	Guya	gka					
gke	Ndai	gke					
gkn	Gokana	gkn					
gko	Kok-Nar	gko					
gkp	Guinea Kpelle	gkp					
gla	Scottish Gaelic	gla	gla	gla	gd	gd	Schottisch-Gälisch;gaélique écossais;gaélique;Gaelic;Schottisches Gälisch
glc	Bon Gula	glc					
gld	Nanai	gld					
gle	Irish	gle	gle	gle	ga	ga	irlandais;Irisch;Gälisch
glg	Galician	glg	glg	glg	gl	gl	galicien;Galicisch
glh	Northwest Pashayi	glh					
gli	Guliguli	gli					
glj	Gula Iro	glj					
glk	Gilaki	glk					
glo	Galambu	glo					
glr	Glaro-Twabo	glr					
glu	Gula (Chad)	glu					
glv	Manx	glv	glv	glv	gv	gv	manx;mannois
glw	Glavda	glw					
gly	Gule	gly					
gma	Gambera	gma					
gmb	Gula'alaa	gmb					
gmd	Mághdì	gmd					
gmh	Middle High German	gmh	gmh	gmh			allemand, moyen haut (ca. 1050-1500);German, Middle High (ca.1050-1500);Mittelhochdeutsch;Middle High German (ca. 1050-1500)
gml	Middle Low German	gml					
gmm	Gbaya-Mbodomo	gmm					
gmn	Gimnime	gmn					
gmu	Gumalu	gmu					
gmv	Gamo	gmv					
gmx	Magoma	gmx					
gmy	Mycenaean Greek	gmy					Mycenaean
gna	Kaansa	gna					
gnb	Gangte	gnb					
gnc	Guanche	gnc					
gnd	Zulgo-Gemzek	gnd					
gne	Ganang	gne					
gng	Ngangam	gng					
gnh	Lere	gnh					
gni	Gooniyandi	gni					
gnk	//Gana	gnk					
gnl	Gangulu	gnl					
gnm	Ginuman	gnm					
gnn	Gumatj	gnn					
gno	Northern Gondi	gno					
gnq	Gana	gnq					
gnr	Gureng Gureng	gnr					
gnt	Guntai	gnt					
gnu	Gnau	gnu					
gnw	Western Bolivian Guaraní	gnw					
gnz	Ganzi	gnz					
goa	Guro	goa					
gob	Playero	gob					
goc	Gorakor	goc					
god	Godié	god					
goe	Gongduk	goe					
gof	Gofa	gof					
gog	Gogo	gog					
goh	Old High German	goh	goh	goh			Old High German (ca. 750-1050);German, Old High (ca.750-1050);allemand, vieux haut (ca. 750-1050);Althochdeutsch
goi	Gobasi	goi					
goj	Gowlan	goj					
gok	Gowli	gok					
gol	Gola	gol					
gom	Goan Konkani	gom					
gon	Gondi	gon	gon	gon			gond
goo	Gone Dau	goo					
gop	Yeretuar	gop					
goq	Gorap	goq					
gor	Gorontalo	gor	gor	gor			gorontalo
gos	Gronings	gos					
got	Gothic	got	got	got			Gotisch;gothique
gou	Gavar	gou					
gow	Gorowa	gow					
gox	Gobu	gox					
goy	Goundo	goy					
goz	Gozarkhani	goz					
gpa	Gupa-Abawa	gpa					
gpe	Ghanaian Pidgin English	gpe					
gpn	Taiap	gpn					
gqa	Ga'anda	gqa					
gqi	Guiqiong	gqi					
gqn	Guana (Brazil)	gqn					
gqr	Gor	gqr					
gqu	Qau	gqu					
gra	Rajput Garasia	gra					
grb	Grebo	grb	grb	grb			grebo
grc	Ancient Greek	grc	grc	grc			Griechisch, Alt-;grec ancien (jusqu'à 1453);Altgriechisch;Greek, Ancient (to 1453);Ancient Greek (to 1453);Mittelgriechisch
grd	Guruntum-Mbaaru	grd					
grg	Madi	grg					
grh	Gbiri-Niragu	grh					
gri	Ghari	gri					
grj	Southern Grebo	grj					
grm	Kota Marudu Talantang	grm					
grn	Guarani	grn	grn	grn	gn	gn	guarani;Guaraní
gro	Groma	gro					
grq	Gorovu	grq					
grr	Taznatit	grr					
grs	Gresi	grs					
grt	Garo	grt					
gru	Kistane	gru					
grv	Central Grebo	grv					
grw	Gweda	grw					
grx	Guriaso	grx					
gry	Barclayville Grebo	gry					
grz	Guramalum	grz					
gse	Ghanaian Sign Language	gse					
gsg	German Sign Language	gsg					
gsl	Gusilay	gsl					
gsm	Guatemalan Sign Language	gsm					
gsn	Gusan	gsn					
gso	Southwest Gbaya	gso					
gsp	Wasembo	gsp					
gss	Greek Sign Language	gss					
gsw	Swiss German	gsw	gsw	gsw			alsacien;Alsatian;Schweizerdeutsch;alémanique;suisse alémanique;Alemannisch;Alemannic
gta	Guató	gta					
gti	Gbati-ri	gti					
gua	Shiki	gua					
gub	Guajajára	gub					
guc	Wayuu	guc					
gud	Yocoboué Dida	gud					
gue	Gurinji	gue					
guf	Gupapuyngu	guf					
gug	Paraguayan Guaraní	gug					
guh	Guahibo	guh					
gui	Eastern Bolivian Guaraní	gui					
guj	Gujarati	guj	guj	guj	gu	gu	goudjrati;Gudscharatisch;Gudscharati
guk	Gumuz	guk					
gul	Sea Island Creole English	gul					
gum	Guambiano	gum					
gun	Mbyá Guaraní	gun					
guo	Guayabero	guo					
gup	Gunwinggu	gup					
guq	Aché	guq					
gur	Farefare	gur					
gus	Guinean Sign Language	gus					
gut	Maléku Jaíka	gut					
guu	Yanomamö	guu					
guv	Gey	guv					
guw	Gun	guw					
gux	Gourmanchéma	gux					
guz	Gusii	guz					
gva	Guana (Paraguay)	gva					
gvc	Guanano	gvc					
gve	Duwet	gve					
gvf	Golin	gvf					
gvj	Guajá	gvj					
gvl	Gulay	gvl					
gvm	Gurmana	gvm					
gvn	Kuku-Yalanji	gvn					
gvo	Gavião Do Jiparaná	gvo					
gvp	Pará Gavião	gvp					
gvr	Western Gurung	gvr					
gvs	Gumawana	gvs					
gvy	Guyani	gvy					
gwa	Mbato	gwa					
gwb	Gwa	gwb					
gwc	Kalami	gwc					
gwd	Gawwada	gwd					
gwe	Gweno	gwe					
gwf	Gowro	gwf					
gwg	Moo	gwg					
gwi	Gwichʼin	gwi	gwi	gwi			Gwich'in;gwich'in
gwj	/Gwi	gwj					
gwm	Awngthim	gwm					
gwn	Gwandara	gwn					
gwr	Gwere	gwr					
gwt	Gawar-Bati	gwt					
gwu	Guwamu	gwu					
gww	Kwini	gww					
gwx	Gua	gwx					
gxx	Wè Southern	gxx					
gya	Northwest Gbaya	gya					
gyb	Garus	gyb					
gyd	Kayardild	gyd					
gye	Gyem	gye					
gyf	Gungabula	gyf					
gyg	Gbayi	gyg					
gyi	Gyele	gyi					
gyl	Gayil	gyl					
gym	Ngäbere	gym					
gyn	Guyanese Creole English	gyn					
gyr	Guarayu	gyr					
gyy	Gunya	gyy					
gza	Ganza	gza					
gzi	Gazi	gzi					
gzn	Gane	gzn					
haa	Han	haa					
hab	Hanoi Sign Language	hab					
hac	Gurani	hac					
had	Hatam	had					
hae	Eastern Oromo	hae					
haf	Haiphong Sign Language	haf					
hag	Hanga	hag					
hah	Hahon	hah					
hai	Haida	hai	hai	hai			haida
haj	Hajong	haj					
hak	Hakka Chinese	hak					Hakka
hal	Halang	hal					
ham	Hewa	ham					
han	Hangaza	han					
hao	Hakö	hao					
hap	Hupla	hap					
haq	Ha	haq					
har	Harari	har					
has	Haisla	has					
hat	Haitian	hat	hat	hat	ht	ht	créole haïtien;Haitian Creole;Haitianisch;Haitisch;haïtien
hau	Hausa	hau	hau	hau	ha	ha	haoussa
hav	Havu	hav					
haw	Hawaiian	haw	haw	haw			Hawaianisch;Hawaiisch;hawaïen
hax	Southern Haida	hax					
hay	Haya	hay					
haz	Hazaragi	haz					
hba	Hamba	hba					
hbb	Huba	hbb					
hbn	Heiban	hbn					
hbo	Ancient Hebrew	hbo					
hbs	Serbo-Croatian	hbs			sh	sh	Serbokroatisch
hbu	Habu	hbu					
hca	Andaman Creole Hindi	hca					
hch	Huichol	hch					
hdn	Northern Haida	hdn					
hds	Honduras Sign Language	hds					
hdy	Hadiyya	hdy					
hea	Northern Qiandong Miao	hea					
heb	Hebrew	heb	heb	heb	he	he	Hebräisch (Ivrit);Ivrit;Hebräisch;hébreu
hed	Herdé	hed					
heg	Helong	heg					
heh	Hehe	heh					
hei	Heiltsuk	hei					
hem	Hemba	hem					
her	Herero	her	her	her	hz	hz	herero
hgm	Hai//om	hgm					
hgw	Haigwai	hgw					
hhi	Hoia Hoia	hhi					
hhr	Kerak	hhr					
hhy	Hoyahoya	hhy					
hia	Lamang	hia					
hib	Hibito	hib					
hid	Hidatsa	hid					
hif	Fiji Hindi	hif					Fijian Hindi
hig	Kamwe	hig					
hih	Pamosu	hih					
hii	Hinduri	hii					
hij	Hijuk	hij					
hik	Seit-Kaitetu	hik					
hil	Hiligaynon	hil	hil	hil			hiligaynon
hin	Hindi	hin	hin	hin	hi	hi	hindi
hio	Tsoa	hio					
hir	Himarimã	hir					
hit	Hittite	hit	hit	hit			Hethitisch;hittite
hiw	Hiw	hiw					
hix	Hixkaryána	hix					
hji	Haji	hji					
hka	Kahe	hka					
hke	Hunde	hke					
hkk	Hunjara-Kaina Ke	hkk					
hks	Hong Kong Sign Language	hks					
hla	Halia	hla					
hlb	Halbi	hlb					
hld	Halang Doan	hld					
hle	Hlersu	hle					
hlt	Matu Chin	hlt					
hlu	Hieroglyphic Luwian	hlu					
hma	Southern Mashan Hmong	hma					
hmb	Humburi Senni Songhay	hmb					
hmc	Central Huishui Hmong	hmc					
hmd	Large Flowery Miao	hmd					
hme	Eastern Huishui Hmong	hme					
hmf	Hmong Don	hmf					
hmg	Southwestern Guiyang Hmong	hmg					
hmh	Southwestern Huishui Hmong	hmh					
hmi	Northern Huishui Hmong	hmi					
hmj	Ge	hmj					
hmk	Maek	hmk					
hml	Luopohe Hmong	hml					
hmm	Central Mashan Hmong	hmm					
hmn	Hmong	hmn	hmn	hmn			Mong;hmong
hmo	Hiri Motu	hmo	hmo	hmo	ho	ho	hiri motu
hmp	Northern Mashan Hmong	hmp					
hmq	Eastern Qiandong Miao	hmq					
hmr	Hmar	hmr					
hms	Southern Qiandong Miao	hms					
hmt	Hamtai	hmt					
hmu	Hamap	hmu					
hmv	Hmong Dô	hmv					
hmw	Western Mashan Hmong	hmw					
hmy	Southern Guiyang Hmong	hmy					
hmz	Hmong Shua	hmz					
hna	Mina (Cameroon)	hna					
hnd	Southern Hindko	hnd					
hne	Chhattisgarhi	hne					
hnh	//Ani	hnh					
hni	Hani	hni					
hnj	Hmong Njua	hnj					
hnn	Hanunoo	hnn					
hno	Northern Hindko	hno					
hns	Caribbean Hindustani	hns					
hnu	Hung	hnu					
hoa	Hoava	hoa					
hob	Mari (Madang Province)	hob					
hoc	Ho	hoc					
hod	Holma	hod					
hoe	Horom	hoe					
hoh	Hobyót	hoh					
hoi	Holikachuk	hoi					
hoj	Hadothi	hoj					
hol	Holu	hol					
hom	Homa	hom					
hoo	Holoholo	hoo					
hop	Hopi	hop					
hor	Horo	hor					
hos	Ho Chi Minh City Sign Language	hos					
hot	Hote	hot					
hov	Hovongan	hov					
how	Honi	how					
hoy	Holiya	hoy					
hoz	Hozo	hoz					
hpo	Hpon	hpo					
hps	Hawai'i Pidgin Sign Language	hps					
hra	Hrangkhol	hra					
hre	Hre	hre					
hrk	Haruku	hrk					
hrm	Horned Miao	hrm					
hro	Haroi	hro					
hrt	Hértevin	hrt					
hru	Hruso	hru					
hrv	Croatian	hrv	hrv	hrv	hr	hr	croate;Kroatisch
hrx	Hunsrik	hrx					
hrz	Harzani	hrz					
hsb	Upper Sorbian	hsb	hsb	hsb			Ober-Sorbisch;Obersorbisch;haut-sorabe
hsh	Hungarian Sign Language	hsh					
hsl	Hausa Sign Language	hsl					
hsn	Xiang Chinese	hsn					Xiang
hss	Harsusi	hss					
hti	Hoti	hti					
hto	Minica Huitoto	hto					
hts	Hadza	hts					
htu	Hitu	htu					
htx	Middle Hittite	htx					
hub	Huambisa	hub					
huc	=/Hua	huc					
hud	Huaulu	hud					
hue	San Francisco Del Mar Huave	hue					
huf	Humene	huf					
hug	Huachipaeri	hug					
huh	Huilliche	huh					
hui	Huli	hui					
huj	Northern Guiyang Hmong	huj					
huk	Hulung	huk					
hul	Hula	hul					
hum	Hungana	hum					
hun	Hungarian	hun	hun	hun	hu	hu	hongrois;Ungarisch
huo	Hu	huo					
hup	Hupa	hup	hup	hup			hupa
huq	Tsat	huq					
hur	Halkomelem	hur					
hus	Huastec	hus					
hut	Humla	hut					
huu	Murui Huitoto	huu					
huv	San Mateo Del Mar Huave	huv					
huw	Hukumina	huw					
hux	Nüpode Huitoto	hux					
huy	Hulaulá	huy					
huz	Hunzib	huz					
hvc	Haitian Vodoun Culture Language	hvc					
hve	San Dionisio Del Mar Huave	hve					
hvk	Haveke	hvk					
hvn	Sabu	hvn					
hvv	Santa María Del Mar Huave	hvv					
hwa	Wané	hwa					
hwc	Hawai'i Creole English	hwc					Hawaiian Pidgin
hwo	Hwana	hwo					
hya	Hya	hya					
hye	Armenian	hye	arm	hye	hy	hy;arm	arménien;Armenisch
iai	Iaai	iai					
ian	Iatmul	ian					
iap	Iapama	iap					
iar	Purari	iar					
iba	Iban	iba	iba	iba			iban
ibb	Ibibio	ibb					
ibd	Iwaidja	ibd					
ibe	Akpes	ibe					
ibg	Ibanag	ibg					
ibl	Ibaloi	ibl					
ibm	Agoi	ibm					
ibn	Ibino	ibn					
ibo	Igbo	ibo	ibo	ibo	ig	ig	igbo;Ibo (Igbo)
ibr	Ibuoro	ibr					
ibu	Ibu	ibu					
iby	Ibani	iby					
ica	Ede Ica	ica					
ich	Etkywan	ich					
icl	Icelandic Sign Language	icl					
icr	Islander Creole English	icr					
ida	Idakho-Isukha-Tiriki	ida					
idb	Indo-Portuguese	idb					
idc	Idon	idc					
idd	Ede Idaca	idd					
ide	Idere	ide					
idi	Idi	idi					
ido	Ido	ido	ido	ido	io	io	ido
idr	Indri	idr					
ids	Idesa	ids					
idt	Idaté	idt					
idu	Idoma	idu					
ifa	Amganad Ifugao	ifa					
ifb	Batad Ifugao	ifb					
ife	Ifè	ife					
iff	Ifo	iff					
ifk	Tuwali Ifugao	ifk					
ifm	Teke-Fuumu	ifm					
ifu	Mayoyao Ifugao	ifu					
ify	Keley-I Kallahan	ify					
igb	Ebira	igb					
ige	Igede	ige					
igg	Igana	igg					
igl	Igala	igl					
igm	Kanggape	igm					
ign	Ignaciano	ign					
igo	Isebe	igo					
igs	Interglossa	igs					
igw	Igwe	igw					
ihb	Iha Based Pidgin	ihb					
ihi	Ihievbe	ihi					
ihp	Iha	ihp					
ihw	Bidhawal	ihw					
iii	Sichuan Yi	iii	iii	iii	ii	ii	Yi;Nuosu;yi de Sichuan
ijc	Izon	ijc					
ije	Biseni	ije					
ijj	Ede Ije	ijj					
ijn	Kalabari	ijn					
ijs	Southeast Ijo	ijs					
ike	Eastern Canadian Inuktitut	ike					
iki	Iko	iki					
ikk	Ika	ikk					
ikl	Ikulu	ikl					
iko	Olulumo-Ikom	iko					
ikp	Ikpeshi	ikp					
ikt	Inuinnaqtun	ikt					
iku	Inuktitut	iku	iku	iku	iu	iu	Eskimoisch/Inuktitut;inuktitut
ikv	Iku-Gora-Ankwa	ikv					
ikw	Ikwere	ikw					
ikx	Ik	ikx					
ikz	Ikizu	ikz					
ila	Ile Ape	ila					
ilb	Ila	ilb					
ile	Interlingue	ile	ile	ile	ie	ie	Interlingue/Occidental;Occidental;interlingue
ilg	Garig-Ilgar	ilg					
ili	Ili Turki	ili					
ilk	Ilongot	ilk					
ill	Iranun	ill					
ilo	Iloko	ilo	ilo	ilo			ilocano;Ilocano;Ilokano
ils	International Sign	ils					
ilu	Ili'uun	ilu					
ilv	Ilue	ilv					
ilw	Talur	ilw					
ima	Mala Malasar	ima					
ime	Imeraguen	ime					
imi	Anamgura	imi					
iml	Miluk	iml					
imn	Imonda	imn					
imo	Imbongu	imo					
imr	Imroing	imr					
ims	Marsian	ims					
imy	Milyan	imy					
ina	Interlingua	ina	ina	ina	ia	ia	interlingua (langue auxiliaire internationale);Interlingua (International Auxiliary Language Association)
inb	Inga	inb					
ind	Indonesian	ind	ind	ind	id	id	indonésien;Indonesisch
ing	Degexit'an	ing					
inh	Ingush	inh	inh	inh			Inguschisch;ingouche
inj	Jungle Inga	inj					
inl	Indonesian Sign Language	inl					
inm	Minaean	inm					
inn	Isinai	inn					
ino	Inoke-Yate	ino					
inp	Iñapari	inp					
ins	Indian Sign Language	ins					
int	Intha	int					
inz	Ineseño	inz					
ior	Inor	ior					
iou	Tuma-Irumu	iou					
iow	Iowa-Oto	iow					
ipi	Ipili	ipi					
ipk	Inupiaq	ipk	ipk	ipk	ik	ik	Inupiak;inupiaq
ipo	Ipiko	ipo					
iqu	Iquito	iqu					
ire	Iresim	ire					
irh	Irarutu	irh					
iri	Irigwe	iri					
irk	Iraqw	irk					
irn	Irántxe	irn					
irr	Ir	irr					
iru	Irula	iru					
irx	Kamberau	irx					
iry	Iraya	iry					
isa	Isabi	isa					
isc	Isconahua	isc					
isd	Isnag	isd					
ise	Italian Sign Language	ise					
isg	Irish Sign Language	isg					
ish	Esan	ish					
isi	Nkem-Nkum	isi					
isk	Ishkashimi	isk					
isl	Icelandic	isl	ice	isl	is	ice;is	islandais;Isländisch
ism	Masimasi	ism					
isn	Isanzu	isn					
iso	Isoko	iso					
isr	Israeli Sign Language	isr					
ist	Istriot	ist					
isu	Isu (Menchum Division)	isu					
ita	Italian	ita	ita	ita	it	it	Italienisch;italien
itb	Binongan Itneg	itb					
ite	Itene	ite					
iti	Inlaod Itneg	iti					
itk	Judeo-Italian	itk					
itl	Itelmen	itl					
itm	Itu Mbon Uzo	itm					
ito	Itonama	ito					
itr	Iteri	itr					
its	Isekiri	its					
itt	Maeng Itneg	itt					
itv	Itawit	itv					
itw	Ito	itw					
itx	Itik	itx					
ity	Moyadan Itneg	ity					
itz	Itzá	itz					
ium	Iu Mien	ium					
ivb	Ibatan	ivb					
ivv	Ivatan	ivv					
iwk	I-Wak	iwk					
iwm	Iwam	iwm					
iwo	Iwur	iwo					
iws	Sepik Iwam	iws					
ixc	Ixcatec	ixc					
ixl	Ixil	ixl					
iya	Iyayu	iya					
iyo	Mesaka	iyo					
iyx	Yaka (Congo)	iyx					
izh	Ingrian	izh					
izi	Izi-Ezaa-Ikwo-Mgbo	izi					
izr	Izere	izr					
jaa	Jamamadí	jaa					
jab	Hyam	jab					
jac	Popti'	jac					
jad	Jahanka	jad					
jae	Yabem	jae					
jaf	Jara	jaf					
jah	Jah Hut	jah					
jaj	Zazao	jaj					
jak	Jakun	jak					
jal	Yalahatan	jal					
jam	Jamaican Creole English	jam					Jamaican Creole
jan	Jandai	jan					
jao	Yanyuwa	jao					
jaq	Yaqay	jaq					
jas	New Caledonian Javanese	jas					
jat	Jakati	jat					
jau	Yaur	jau					
jav	Javanese	jav	jav	jav	jv	jv	javanais;Javanisch
jax	Jambi Malay	jax					
jay	Yan-nhangu	jay					
jaz	Jawe	jaz					
jbe	Judeo-Berber	jbe					
jbj	Arandai	jbj					
jbk	Barikewa	jbk					
jbn	Nafusi	jbn					
jbo	Lojban	jbo	jbo	jbo			lojban
jbr	Jofotek-Bromnya	jbr					
jbt	Jabutí	jbt					
jbu	Jukun Takum	jbu					
jbw	Yawijibaya	jbw					
jcs	Jamaican Country Sign Language	jcs					
jct	Krymchak	jct					
jda	Jad	jda					
jdg	Jadgali	jdg					
jdt	Judeo-Tat	jdt					
jeb	Jebero	jeb					
jee	Jerung	jee					
jeg	Jeng	jeg					
jeh	Jeh	jeh					
jei	Yei	jei					
jek	Jeri Kuo	jek					
jel	Yelmek	jel					
jen	Dza	jen					
jer	Jere	jer					
jet	Manem	jet					
jeu	Jonkor Bourmataguil	jeu					
jgb	Ngbee	jgb					
jge	Judeo-Georgian	jge					
jgk	Gwak	jgk					
jgo	Ngomba	jgo					
jhi	Jehai	jhi					
jhs	Jhankot Sign Language	jhs					
jia	Jina	jia					
jib	Jibu	jib					
jic	Tol	jic					
jid	Bu	jid					
jie	Jilbe	jie					
jig	Djingili	jig					
jih	sTodsde	jih					
jii	Jiiddu	jii					
jil	Jilim	jil					
jim	Jimi (Cameroon)	jim					
jio	Jiamao	jio					
jiq	Guanyinqiao	jiq					
jit	Jita	jit					
jiu	Youle Jinuo	jiu					
jiv	Shuar	jiv					
jiy	Buyuan Jinuo	jiy					
jjr	Bankal	jjr					
jkm	Mobwa Karen	jkm					
jko	Kubo	jko					
jkp	Paku Karen	jkp					
jkr	Koro (India)	jkr					
jku	Labir	jku					
jle	Ngile	jle					
jls	Jamaican Sign Language	jls					
jma	Dima	jma					
jmb	Zumbun	jmb					
jmc	Machame	jmc					
jmd	Yamdena	jmd					
jmi	Jimi (Nigeria)	jmi					
jml	Jumli	jml					
jmn	Makuri Naga	jmn					
jmr	Kamara	jmr					
jms	Mashi (Nigeria)	jms					
jmw	Mouwase	jmw					
jmx	Western Juxtlahuaca Mixtec	jmx					
jna	Jangshung	jna					
jnd	Jandavra	jnd					
jng	Yangman	jng					
jni	Janji	jni					
jnj	Yemsa	jnj					
jnl	Rawat	jnl					
jns	Jaunsari	jns					
job	Joba	job					
jod	Wojenaka	jod					
jor	Jorá	jor					
jos	Jordanian Sign Language	jos					
jow	Jowulu	jow					
jpa	Jewish Palestinian Aramaic	jpa					
jpn	Japanese	jpn	jpn	jpn	ja	ja	japonais;Japanisch
jpr	Judeo-Persian	jpr	jpr	jpr			judéo-persan
jqr	Jaqaru	jqr					
jra	Jarai	jra					
jrb	Judeo-Arabic	jrb	jrb	jrb			judéo-arabe
jrr	Jiru	jrr					
jrt	Jorto	jrt					
jru	Japrería	jru					
jsl	Japanese Sign Language	jsl					
jua	Júma	jua					
jub	Wannu	jub					
juc	Jurchen	juc					
jud	Worodougou	jud					
juh	Hõne	juh					
jui	Ngadjuri	jui					
juk	Wapan	juk					
jul	Jirel	jul					
jum	Jumjum	jum					
jun	Juang	jun					
juo	Jiba	juo					
jup	Hupdë	jup					
jur	Jurúna	jur					
jus	Jumla Sign Language	jus					
jut	Jutish	jut					
juu	Ju	juu					
juw	Wãpha	juw					
juy	Juray	juy					
jvd	Javindo	jvd					
jvn	Caribbean Javanese	jvn					
jwi	Jwira-Pepesa	jwi					
jya	Jiarong	jya					
jye	Judeo-Yemeni Arabic	jye					
jyy	Jaya	jyy					
kaa	Kara-Kalpak	kaa	kaa	kaa			Karakalpakisch;karakalpak
kab	Kabyle	kab	kab	kab			kabyle
kac	Kachin	kac	kac	kac			kachin;Jingpho;jingpho
kad	Adara	kad					
kae	Ketangalan	kae					
kaf	Katso	kaf					
kag	Kajaman	kag					
kah	Kara (Central African Republic)	kah					
kai	Karekare	kai					
kaj	Jju	kaj					
kak	Kayapa Kallahan	kak					
kal	Kalaallisut	kal	kal	kal	kl	kl	Grönländisch;groenlandais;Grönländisch/Kalaallisut;Greenlandic
kam	Kamba (Kenya)	kam	kam	kam			kamba;Kamba
kan	Kannada	kan	kan	kan	kn	kn	Kannaresisch;Kanaresisch;kannada
kao	Xaasongaxango	kao					
kap	Bezhta	kap					
kaq	Capanahua	kaq					
kas	Kashmiri	kas	kas	kas	ks	ks	Kaschmiri;Kaschmirisch;kashmiri
kat	Georgian	kat	geo	kat	ka	geo;ka	géorgien;Georgisch/Grusinisch;Georgisch
kau	Kanuri	kau	kau	kau	kr	kr	kanouri
kav	Katukína	kav					
kaw	Kawi	kaw	kaw	kaw			kawi
kax	Kao	kax					
kay	Kamayurá	kay					
kaz	Kazakh	kaz	kaz	kaz	kk	kk	kazakh;Kasachisch
kba	Kalarko	kba					
kbb	Kaxuiâna	kbb					
kbc	Kadiwéu	kbc					
kbd	Kabardian	kbd	kbd	kbd			kabardien;Tscherkessisch (Kabardisch)
kbe	Kanju	kbe					
kbf	Kakauhua	kbf					
kbg	Khamba	kbg					
kbh	Camsá	kbh					
kbi	Kaptiau	kbi					
kbj	Kari	kbj					
kbk	Grass Koiari	kbk					
kbl	Kanembu	kbl					
kbm	Iwal	kbm					
kbn	Kare (Central African Republic)	kbn					
kbo	Keliko	kbo					
kbp	Kabiyè	kbp					
kbq	Kamano	kbq					
kbr	Kafa	kbr					
kbs	Kande	kbs					
kbt	Abadi	kbt					
kbu	Kabutra	kbu					
kbv	Dera (Indonesia)	kbv					
kbw	Kaiep	kbw					
kbx	Ap Ma	kbx					
kby	Manga Kanuri	kby					
kbz	Duhwa	kbz					
kca	Khanty	kca					Chantyisch;Chantisch
kcb	Kawacha	kcb					
kcc	Lubila	kcc					
kcd	Ngkâlmpw Kanum	kcd					
kce	Kaivi	kce					
kcf	Ukaan	kcf					
kcg	Tyap	kcg					
kch	Vono	kch					
kci	Kamantan	kci					
kcj	Kobiana	kcj					
kck	Kalanga	kck					
kcl	Kela (Papua New Guinea)	kcl					
kcm	Gula (Central African Republic)	kcm					
kcn	Nubi	kcn					
kco	Kinalakna	kco					
kcp	Kanga	kcp					
kcq	Kamo	kcq					
kcr	Katla	kcr					
kcs	Koenoem	kcs					
kct	Kaian	kct					
kcu	Kami (Tanzania)	kcu					
kcv	Kete	kcv					
kcw	Kabwari	kcw					
kcx	Kachama-Ganjule	kcx					
kcy	Korandje	kcy					
kcz	Konongo	kcz					
kda	Worimi	kda					
kdc	Kutu	kdc					
kdd	Yankunytjatjara	kdd					
kde	Makonde	kde					
kdf	Mamusi	kdf					
kdg	Seba	kdg					
kdh	Tem	kdh					
kdi	Kumam	kdi					
kdj	Karamojong	kdj					
kdk	Numee	kdk					
kdl	Tsikimba	kdl					
kdm	Kagoma	kdm					
kdn	Kunda	kdn					
kdp	Kaningdon-Nindem	kdp					
kdq	Koch	kdq					
kdr	Karaim	kdr					Troki-Karaimisch;Krim-Karaimisch
kdt	Kuy	kdt					
kdu	Kadaru	kdu					
kdw	Koneraw	kdw					
kdx	Kam	kdx					
kdy	Keder	kdy					
kdz	Kwaja	kdz					
kea	Kabuverdianu	kea					Cape Verdean Creole;Badiu or Santiago;Badiu
keb	Kélé	keb					
kec	Keiga	kec					
ked	Kerewe	ked					
kee	Eastern Keres	kee					
kef	Kpessi	kef					
keg	Tese	keg					
keh	Keak	keh					
kei	Kei	kei					
kej	Kadar	kej					
kek	Kekchí	kek					
kel	Kela (Democratic Republic of Congo)	kel					
kem	Kemak	kem					
ken	Kenyang	ken					
keo	Kakwa	keo					
kep	Kaikadi	kep					
keq	Kamar	keq					
ker	Kera	ker					
kes	Kugbo	kes					
ket	Ket	ket					
keu	Akebu	keu					
kev	Kanikkaran	kev					
kew	West Kewa	kew					
kex	Kukna	kex					
key	Kupia	key					
kez	Kukele	kez					
kfa	Kodava	kfa					
kfb	Northwestern Kolami	kfb					
kfc	Konda-Dora	kfc					
kfd	Korra Koraga	kfd					
kfe	Kota (India)	kfe					
kff	Koya	kff					
kfg	Kudiya	kfg					
kfh	Kurichiya	kfh					
kfi	Kannada Kurumba	kfi					
kfj	Kemiehua	kfj					
kfk	Kinnauri	kfk					
kfl	Kung	kfl					
kfm	Khunsari	kfm					
kfn	Kuk	kfn					
kfo	Koro (Côte d'Ivoire)	kfo					
kfp	Korwa	kfp					
kfq	Korku	kfq					
kfr	Kachchi	kfr					
kfs	Bilaspuri	kfs					
kft	Kanjari	kft					
kfu	Katkari	kfu					
kfv	Kurmukar	kfv					
kfw	Kharam Naga	kfw					
kfx	Kullu Pahari	kfx					
kfy	Kumaoni	kfy					
kfz	Koromfé	kfz					
kga	Koyaga	kga					
kgb	Kawe	kgb					
kgc	Kasseng	kgc					
kgd	Kataang	kgd					
kge	Komering	kge					
kgf	Kube	kgf					
kgg	Kusunda	kgg					
kgi	Selangor Sign Language	kgi					
kgj	Gamale Kham	kgj					
kgk	Kaiwá	kgk					
kgl	Kunggari	kgl					
kgm	Karipúna	kgm					
kgn	Karingani	kgn					
kgo	Krongo	kgo					
kgp	Kaingang	kgp					
kgq	Kamoro	kgq					
kgr	Abun	kgr					
kgs	Kumbainggar	kgs					
kgt	Somyev	kgt					
kgu	Kobol	kgu					
kgv	Karas	kgv					
kgw	Karon Dori	kgw					
kgx	Kamaru	kgx					
kgy	Kyerung	kgy					
kha	Khasi	kha	kha	kha			khasi
khb	Lü	khb					
khc	Tukang Besi North	khc					
khd	Bädi Kanum	khd					
khe	Korowai	khe					
khf	Khuen	khf					
khg	Khams Tibetan	khg					
khh	Kehu	khh					
khj	Kuturmi	khj					
khk	Halh Mongolian	khk					
khl	Lusi	khl					
khm	Central Khmer	khm	khm	khm	km	km	Kambodschanisch/Khmer-Sprache;Khmer;khmer central
khn	Khandesi	khn					
kho	Khotanese	kho	kho	kho			khotanais;sakan;Sakan
khp	Kapori	khp					
khq	Koyra Chiini Songhay	khq					
khr	Kharia	khr					
khs	Kasua	khs					
kht	Khamti	kht					
khu	Nkhumbi	khu					
khv	Khvarshi	khv					
khw	Khowar	khw					
khx	Kanu	khx					
khy	Kele (Democratic Republic of Congo)	khy					
khz	Keapara	khz					
kia	Kim	kia					
kib	Koalib	kib					
kic	Kickapoo	kic					
kid	Koshin	kid					
kie	Kibet	kie					
kif	Eastern Parbate Kham	kif					
kig	Kimaama	kig					
kih	Kilmeri	kih					
kii	Kitsai	kii					
kij	Kilivila	kij					
kik	Kikuyu	kik	kik	kik	ki	ki	Gikuyu;kikuyu
kil	Kariya	kil					
kim	Karagas	kim					
kin	Kinyarwanda	kin	kin	kin	rw	rw	rwanda
kio	Kiowa	kio					
kip	Sheshi Kham	kip					
kiq	Kosadle	kiq					
kir	Kirghiz	kir	kir	kir	ky	ky	Kirgisisch;Kyrgyz;kirghiz
kis	Kis	kis					
kit	Agob	kit					
kiu	Kirmanjki (individual language)	kiu					
kiv	Kimbu	kiv					
kiw	Northeast Kiwai	kiw					
kix	Khiamniungan Naga	kix					
kiy	Kirikiri	kiy					
kiz	Kisi	kiz					
kja	Mlap	kja					
kjb	Q'anjob'al	kjb					
kjc	Coastal Konjo	kjc					
kjd	Southern Kiwai	kjd					
kje	Kisar	kje					
kjf	Khalaj	kjf					
kjg	Khmu	kjg					
kjh	Khakas	kjh					Chakassisch
kji	Zabana	kji					
kjj	Khinalugh	kjj					Chinalugisch
kjk	Highland Konjo	kjk					
kjl	Western Parbate Kham	kjl					
kjm	Kháng	kjm					
kjn	Kunjen	kjn					
kjo	Harijan Kinnauri	kjo					
kjp	Pwo Eastern Karen	kjp					
kjq	Western Keres	kjq					
kjr	Kurudu	kjr					
kjs	East Kewa	kjs					
kjt	Phrae Pwo Karen	kjt					
kju	Kashaya	kju					
kjx	Ramopa	kjx					
kjy	Erave	kjy					
kjz	Bumthangkha	kjz					
kka	Kakanda	kka					
kkb	Kwerisa	kkb					
kkc	Odoodee	kkc					
kkd	Kinuku	kkd					
kke	Kakabe	kke					
kkf	Kalaktang Monpa	kkf					
kkg	Mabaka Valley Kalinga	kkg					
kkh	Khün	kkh					
kki	Kagulu	kki					
kkj	Kako	kkj					
kkk	Kokota	kkk					
kkl	Kosarek Yale	kkl					
kkm	Kiong	kkm					
kkn	Kon Keu	kkn					
kko	Karko	kko					
kkp	Gugubera	kkp					
kkq	Kaiku	kkq					
kkr	Kir-Balar	kkr					
kks	Giiwo	kks					
kkt	Koi	kkt					
kku	Tumi	kku					
kkv	Kangean	kkv					
kkw	Teke-Kukuya	kkw					
kkx	Kohin	kkx					
kky	Guguyimidjir	kky					Guugu Yimidhirr
kkz	Kaska	kkz					
kla	Klamath-Modoc	kla					
klb	Kiliwa	klb					
klc	Kolbila	klc					
kld	Gamilaraay	kld					
kle	Kulung (Nepal)	kle					
klf	Kendeje	klf					
klg	Tagakaulo	klg					
klh	Weliki	klh					
kli	Kalumpang	kli					
klj	Turkic Khalaj	klj					
klk	Kono (Nigeria)	klk					
kll	Kagan Kalagan	kll					
klm	Migum	klm					
kln	Kalenjin	kln					
klo	Kapya	klo					
klp	Kamasa	klp					
klq	Rumu	klq					
klr	Khaling	klr					
kls	Kalasha	kls					
klt	Nukna	klt					
klu	Klao	klu					
klv	Maskelynes	klv					
klw	Lindu	klw					
klx	Koluwawa	klx					
kly	Kalao	kly					
klz	Kabola	klz					
kma	Konni	kma					
kmb	Kimbundu	kmb	kmb	kmb			kimbundu
kmc	Southern Dong	kmc					
kmd	Majukayang Kalinga	kmd					
kme	Bakole	kme					
kmf	Kare (Papua New Guinea)	kmf					
kmg	Kâte	kmg					
kmh	Kalam	kmh					
kmi	Kami (Nigeria)	kmi					
kmj	Kumarbhag Paharia	kmj					
kmk	Limos Kalinga	kmk					
kml	Tanudan Kalinga	kml					
kmm	Kom (India)	kmm					
kmn	Awtuw	kmn					
kmo	Kwoma	kmo					
kmp	Gimme	kmp					
kmq	Kwama	kmq					
kmr	Northern Kurdish	kmr					Kurmanji;Kurmancî
kms	Kamasau	kms					
kmt	Kemtuik	kmt					
kmu	Kanite	kmu					
kmv	Karipúna Creole French	kmv					
kmw	Komo (Democratic Republic of Congo)	kmw					
kmx	Waboda	kmx					
kmy	Koma	kmy					
kmz	Khorasani Turkish	kmz					
kna	Dera (Nigeria)	kna					
knb	Lubuagan Kalinga	knb					
knc	Central Kanuri	knc					
knd	Konda	knd					
kne	Kankanaey	kne					
knf	Mankanya	knf					
kng	Koongo	kng					
kni	Kanufi	kni					
knj	Western Kanjobal	knj					
knk	Kuranko	knk					
knl	Keninjal	knl					
knm	Kanamarí	knm					
knn	Konkani (individual language)	knn					
kno	Kono (Sierra Leone)	kno					
knp	Kwanja	knp					
knq	Kintaq	knq					
knr	Kaningra	knr					
kns	Kensiu	kns					
knt	Panoan Katukína	knt					
knu	Kono (Guinea)	knu					
knv	Tabo	knv					
knw	Kung-Ekoka	knw					!Kung
knx	Kendayan	knx					
kny	Kanyok	kny					
knz	Kalamsé	knz					
koa	Konomala	koa					
koc	Kpati	koc					
kod	Kodi	kod					
koe	Kacipo-Balesi	koe					
kof	Kubi	kof					
kog	Cogui	kog					
koh	Koyo	koh					
koi	Komi-Permyak	koi					Komi-Permjakisch
koj	Sara Dunjo	koj					
kok	Konkani	kok	kok	kok			Konkani (macrolanguage);konkani
kol	Kol (Papua New Guinea)	kol					
kom	Komi	kom	kom	kom	kv	kv	kom
kon	Kongo	kon	kon	kon	kg	kg	kongo
koo	Konzo	koo					
kop	Waube	kop					
koq	Kota (Gabon)	koq					
kor	Korean	kor	kor	kor	ko	ko	coréen;Koreanisch
kos	Kosraean	kos	kos	kos			Kosrae;kosrae
kot	Lagwan	kot					
kou	Koke	kou					
kov	Kudu-Camo	kov					
kow	Kugama	kow					
kox	Coxima	kox					
koy	Koyukon	koy					
koz	Korak	koz					
kpa	Kutto	kpa					
kpb	Mullu Kurumba	kpb					
kpc	Curripaco	kpc					
kpd	Koba	kpd					
kpe	Kpelle	kpe	kpe	kpe			kpellé
kpf	Komba	kpf					
kpg	Kapingamarangi	kpg					
kph	Kplang	kph					
kpi	Kofei	kpi					
kpj	Karajá	kpj					
kpk	Kpan	kpk					
kpl	Kpala	kpl					
kpm	Koho	kpm					
kpn	Kepkiriwát	kpn					
kpo	Ikposo	kpo					
kpq	Korupun-Sela	kpq					
kpr	Korafe-Yegha	kpr					
kps	Tehit	kps					
kpt	Karata	kpt					
kpu	Kafoa	kpu					
kpv	Komi-Zyrian	kpv					Komi-Syrjänisch
kpw	Kobon	kpw					
kpx	Mountain Koiali	kpx					
kpy	Koryak	kpy					
kpz	Kupsabiny	kpz					
kqa	Mum	kqa					
kqb	Kovai	kqb					
kqc	Doromu-Koki	kqc					
kqd	Koy Sanjaq Surat	kqd					
kqe	Kalagan	kqe					
kqf	Kakabai	kqf					
kqg	Khe	kqg					
kqh	Kisankasa	kqh					
kqi	Koitabu	kqi					
kqj	Koromira	kqj					
kqk	Kotafon Gbe	kqk					
kql	Kyenele	kql					
kqm	Khisa	kqm					
kqn	Kaonde	kqn					
kqo	Eastern Krahn	kqo					
kqp	Kimré	kqp					
kqq	Krenak	kqq					
kqr	Kimaragang	kqr					
kqs	Northern Kissi	kqs					
kqt	Klias River Kadazan	kqt					
kqu	Seroa	kqu					
kqv	Okolod	kqv					
kqw	Kandas	kqw					
kqx	Mser	kqx					
kqy	Koorete	kqy					
kqz	Korana	kqz					
kra	Kumhali	kra					
krb	Karkin	krb					
krc	Karachay-Balkar	krc	krc	krc			karatchai balkar;Karatschai-Balkarisch
krd	Kairui-Midiki	krd					
kre	Panará	kre					
krf	Koro (Vanuatu)	krf					
krh	Kurama	krh					
kri	Krio	kri					
krj	Kinaray-A	krj					
krk	Kerek	krk					
krl	Karelian	krl	krl	krl			carélien;Karelisch
krm	Krim	krm					
krn	Sapo	krn					
krp	Korop	krp					
krr	Kru'ng 2	krr					
krs	Gbaya (Sudan)	krs					
krt	Tumari Kanuri	krt					
kru	Kurukh	kru	kru	kru			kurukh
krv	Kavet	krv					
krw	Western Krahn	krw					
krx	Karon	krx					
kry	Kryts	kry					
krz	Sota Kanum	krz					
ksa	Shuwa-Zamani	ksa					
ksb	Shambala	ksb					
ksc	Southern Kalinga	ksc					
ksd	Kuanua	ksd					
kse	Kuni	kse					
ksf	Bafia	ksf					
ksg	Kusaghe	ksg					
ksh	Kölsch	ksh					
ksi	Krisa	ksi					
ksj	Uare	ksj					
ksk	Kansa	ksk					
ksl	Kumalu	ksl					
ksm	Kumba	ksm					
ksn	Kasiguranin	ksn					
kso	Kofa	kso					
ksp	Kaba	ksp					
ksq	Kwaami	ksq					
ksr	Borong	ksr					
kss	Southern Kisi	kss					
kst	Winyé	kst					
ksu	Khamyang	ksu					
ksv	Kusu	ksv					
ksw	S'gaw Karen	ksw					
ksx	Kedang	ksx					
ksy	Kharia Thar	ksy					
ksz	Kodaku	ksz					
kta	Katua	kta					
ktb	Kambaata	ktb					
ktc	Kholok	ktc					
ktd	Kokata	ktd					
kte	Nubri	kte					
ktf	Kwami	ktf					
ktg	Kalkutung	ktg					
kth	Karanga	kth					
kti	North Muyu	kti					
ktj	Plapo Krumen	ktj					
ktk	Kaniet	ktk					
ktl	Koroshi	ktl					
ktm	Kurti	ktm					
ktn	Karitiâna	ktn					
kto	Kuot	kto					
ktp	Kaduo	ktp					
ktq	Katabaga	ktq					
ktr	Kota Marudu Tinagas	ktr					
kts	South Muyu	kts					
ktt	Ketum	ktt					
ktu	Kituba (Democratic Republic of Congo)	ktu					
ktv	Eastern Katu	ktv					
ktw	Kato	ktw					
ktx	Kaxararí	ktx					
kty	Kango (Bas-Uélé District)	kty					
ktz	Ju/'hoan	ktz					
kua	Kuanyama	kua	kua	kua	kj	kj	kwanyama;kuanyama;Kwanyama
kub	Kutep	kub					
kuc	Kwinsu	kuc					
kud	'Auhelawa	kud					
kue	Kuman	kue					
kuf	Western Katu	kuf					
kug	Kupa	kug					
kuh	Kushi	kuh					
kui	Kuikúro-Kalapálo	kui					
kuj	Kuria	kuj					
kuk	Kepo'	kuk					
kul	Kulere	kul					
kum	Kumyk	kum	kum	kum			koumyk;Kumükisch
kun	Kunama	kun					
kuo	Kumukio	kuo					
kup	Kunimaipa	kup					
kuq	Karipuna	kuq					
kur	Kurdish	kur	kur	kur	ku	ku	kurde;Zazaisch;Kurdisch (Kurmanji);Kurdisch (Sorani);Sorani;Kurdisch;Kurmandschi
kus	Kusaal	kus					
kut	Kutenai	kut	kut	kut			kutenai
kuu	Upper Kuskokwim	kuu					
kuv	Kur	kuv					
kuw	Kpagua	kuw					
kux	Kukatja	kux					
kuy	Kuuku-Ya'u	kuy					
kuz	Kunza	kuz					
kva	Bagvalal	kva					
kvb	Kubu	kvb					
kvc	Kove	kvc					
kvd	Kui (Indonesia)	kvd					
kve	Kalabakan	kve					
kvf	Kabalai	kvf					
kvg	Kuni-Boazi	kvg					
kvh	Komodo	kvh					
kvi	Kwang	kvi					
kvj	Psikye	kvj					
kvk	Korean Sign Language	kvk					
kvl	Kayaw	kvl					
kvm	Kendem	kvm					
kvn	Border Kuna	kvn					
kvo	Dobel	kvo					
kvp	Kompane	kvp					
kvq	Geba Karen	kvq					
kvr	Kerinci	kvr					
kvs	Kunggara	kvs					
kvt	Lahta Karen	kvt					
kvu	Yinbaw Karen	kvu					
kvv	Kola	kvv					
kvw	Wersing	kvw					
kvx	Parkari Koli	kvx					
kvy	Yintale Karen	kvy					
kvz	Tsakwambo	kvz					
kwa	Dâw	kwa					
kwb	Kwa	kwb					
kwc	Likwala	kwc					
kwd	Kwaio	kwd					
kwe	Kwerba	kwe					
kwf	Kwara'ae	kwf					
kwg	Sara Kaba Deme	kwg					
kwh	Kowiai	kwh					
kwi	Awa-Cuaiquer	kwi					
kwj	Kwanga	kwj					
kwk	Kwakiutl	kwk					
kwl	Kofyar	kwl					
kwm	Kwambi	kwm					
kwn	Kwangali	kwn					
kwo	Kwomtari	kwo					
kwp	Kodia	kwp					
kwq	Kwak	kwq					
kwr	Kwer	kwr					
kws	Kwese	kws					
kwt	Kwesten	kwt					
kwu	Kwakum	kwu					
kwv	Sara Kaba Náà	kwv					
kww	Kwinti	kww					
kwx	Khirwar	kwx					
kwy	San Salvador Kongo	kwy					
kwz	Kwadi	kwz					
kxa	Kairiru	kxa					
kxb	Krobu	kxb					
kxc	Konso	kxc					
kxd	Brunei	kxd					
kxe	Kakihum	kxe					
kxf	Manumanaw Karen	kxf					
kxh	Karo (Ethiopia)	kxh					
kxi	Keningau Murut	kxi					
kxj	Kulfa	kxj					
kxk	Zayein Karen	kxk					
kxl	Nepali Kurux	kxl					
kxm	Northern Khmer	kxm					
kxn	Kanowit-Tanjong Melanau	kxn					
kxo	Kanoé	kxo					
kxp	Wadiyara Koli	kxp					
kxq	Smärky Kanum	kxq					
kxr	Koro (Papua New Guinea)	kxr					
kxs	Kangjia	kxs					
kxt	Koiwat	kxt					
kxu	Kui (India)	kxu					
kxv	Kuvi	kxv					
kxw	Konai	kxw					
kxx	Likuba	kxx					
kxy	Kayong	kxy					
kxz	Kerewo	kxz					
kya	Kwaya	kya					
kyb	Butbut Kalinga	kyb					
kyc	Kyaka	kyc					
kyd	Karey	kyd					
kye	Krache	kye					
kyf	Kouya	kyf					
kyg	Keyagana	kyg					
kyh	Karok	kyh					
kyi	Kiput	kyi					
kyj	Karao	kyj					
kyk	Kamayo	kyk					
kyl	Kalapuya	kyl					
kym	Kpatili	kym					
kyn	Northern Binukidnon	kyn					
kyo	Kelon	kyo					
kyp	Kang	kyp					
kyq	Kenga	kyq					
kyr	Kuruáya	kyr					
kys	Baram Kayan	kys					
kyt	Kayagar	kyt					
kyu	Western Kayah	kyu					
kyv	Kayort	kyv					
kyw	Kudmali	kyw					
kyx	Rapoisi	kyx					
kyy	Kambaira	kyy					
kyz	Kayabí	kyz					
kza	Western Karaboro	kza					
kzb	Kaibobo	kzb					
kzc	Bondoukou Kulango	kzc					
kzd	Kadai	kzd					
kze	Kosena	kze					
kzf	Da'a Kaili	kzf					
kzg	Kikai	kzg					
kzi	Kelabit	kzi					
kzj	Coastal Kadazan	kzj					
kzk	Kazukuru	kzk					
kzl	Kayeli	kzl					
kzm	Kais	kzm					
kzn	Kokola	kzn					
kzo	Kaningi	kzo					
kzp	Kaidipang	kzp					
kzq	Kaike	kzq					
kzr	Karang	kzr					
kzs	Sugut Dusun	kzs					
kzt	Tambunan Dusun	kzt					
kzu	Kayupulau	kzu					
kzv	Komyandaret	kzv					
kzw	Karirí-Xocó	kzw					
kzx	Kamarian	kzx					
kzy	Kango (Tshopo District)	kzy					
kzz	Kalabra	kzz					
laa	Southern Subanen	laa					
lab	Linear A	lab					
lac	Lacandon	lac					
lad	Ladino	lad	lad	lad			judéo-espagnol;Sephardisch (Ladino);Ladino/Sephardisch
lae	Pattani	lae					
laf	Lafofa	laf					
lag	Langi	lag					
lah	Lahnda	lah	lah	lah			lahnda
lai	Lambya	lai					
laj	Lango (Uganda)	laj					
lak	Laka (Nigeria)	lak					
lal	Lalia	lal					
lam	Lamba	lam	lam	lam			lamba
lan	Laru	lan					
lao	Lao	lao	lao	lao	lo	lo	Laotisch;lao
lap	Laka (Chad)	lap					
laq	Qabiao	laq					
lar	Larteh	lar					
las	Lama (Togo)	las					
lat	Latin	lat	lat	lat	la	la	Latein;latin;Lateinisch
lau	Laba	lau					
lav	Latvian	lav	lav	lav	lv	lv	letton;Lettisch
law	Lauje	law					
lax	Tiwa	lax					
lay	Lama (Myanmar)	lay					
laz	Aribwatsa	laz					
lba	Lui	lba					
lbb	Label	lbb					
lbc	Lakkia	lbc					
lbe	Lak	lbe					
lbf	Tinani	lbf					
lbg	Laopang	lbg					
lbi	La'bi	lbi					
lbj	Ladakhi	lbj					
lbk	Central Bontok	lbk					
lbl	Libon Bikol	lbl					
lbm	Lodhi	lbm					
lbn	Lamet	lbn					
lbo	Laven	lbo					
lbq	Wampar	lbq					
lbr	Lohorung	lbr					
lbs	Libyan Sign Language	lbs					
lbt	Lachi	lbt					
lbu	Labu	lbu					
lbv	Lavatbura-Lamusong	lbv					
lbw	Tolaki	lbw					
lbx	Lawangan	lbx					
lby	Lamu-Lamu	lby					
lbz	Lardil	lbz					
lcc	Legenyem	lcc					
lcd	Lola	lcd					
lce	Loncong	lce					
lcf	Lubu	lcf					
lch	Luchazi	lch					
lcl	Lisela	lcl					
lcm	Tungag	lcm					
lcp	Western Lawa	lcp					
lcs	Lisabata-Nuniali	lcs					
ldb	Dũya	ldb					
ldd	Luri	ldd					
ldg	Lenyima	ldg					
ldh	Lamja-Dengsa-Tola	ldh					
ldi	Laari	ldi					
ldj	Lemoro	ldj					
ldk	Leelau	ldk					
ldl	Kaan	ldl					
ldm	Landoma	ldm					
ldn	Láadan	ldn					
ldo	Loo	ldo					
ldp	Tso	ldp					
ldq	Lufu	ldq					
lea	Lega-Shabunda	lea					
leb	Lala-Bisa	leb					
lec	Leco	lec					
led	Lendu	led					
lee	Lyélé	lee					
lef	Lelemi	lef					
leg	Lengua	leg					
leh	Lenje	leh					
lei	Lemio	lei					
lej	Lengola	lej					
lek	Leipon	lek					
lel	Lele (Democratic Republic of Congo)	lel					
lem	Nomaande	lem					
len	Lenca	len					
leo	Leti (Cameroon)	leo					
lep	Lepcha	lep					
leq	Lembena	leq					
ler	Lenkau	ler					
les	Lese	les					
let	Lesing-Gelimi	let					
leu	Kara (Papua New Guinea)	leu					
lev	Lamma	lev					
lew	Ledo Kaili	lew					
lex	Luang	lex					
ley	Lemolang	ley					
lez	Lezghian	lez	lez	lez			Lezgi;lezghien
lfa	Lefa	lfa					
lfn	Lingua Franca Nova	lfn					
lga	Lungga	lga					
lgb	Laghu	lgb					
lgg	Lugbara	lgg					
lgh	Laghuu	lgh					
lgi	Lengilu	lgi					
lgk	Lingarak	lgk					
lgl	Wala	lgl					
lgm	Lega-Mwenga	lgm					
lgn	Opuuo	lgn					
lgq	Logba	lgq					
lgr	Lengo	lgr					
lgt	Pahi	lgt					
lgu	Longgu	lgu					
lgz	Ligenza	lgz					
lha	Laha (Viet Nam)	lha					
lhh	Laha (Indonesia)	lhh					
lhi	Lahu Shi	lhi					
lhl	Lahul Lohar	lhl					
lhm	Lhomi	lhm					
lhn	Lahanan	lhn					
lhp	Lhokpu	lhp					
lhs	Mlahsö	lhs					
lht	Lo-Toga	lht					
lhu	Lahu	lhu					
lia	West-Central Limba	lia					
lib	Likum	lib					
lic	Hlai	lic					
lid	Nyindrou	lid					
lie	Likila	lie					
lif	Limbu	lif					
lig	Ligbi	lig					
lih	Lihir	lih					
lii	Lingkhim	lii					
lij	Ligurian	lij					
lik	Lika	lik					
lil	Lillooet	lil					
lim	Limburgan	lim	lim	lim	li	li	Limburger;Limburgisch;Limburgish;Limburgisch-Bergisch;limbourgeois;Limburghese
lin	Lingala	lin	lin	lin	ln	ln	lingala
lio	Liki	lio					
lip	Sekpele	lip					
liq	Libido	liq					
lir	Liberian English	lir					
lis	Lisu	lis					
lit	Lithuanian	lit	lit	lit	lt	lt	Litauisch;lituanien
liu	Logorik	liu					
liv	Liv	liv				fiu-liv	Livonian;Livisch
liw	Col	liw					
lix	Liabuku	lix					
liy	Banda-Bambari	liy					
liz	Libinza	liz					
lje	Rampi	lje					
lji	Laiyolo	lji					
ljl	Li'o	ljl					
ljp	Lampung Api	ljp					
lka	Lakalei	lka					
lkb	Kabras	lkb					
lkc	Kucong	lkc					
lkd	Lakondê	lkd					
lke	Kenyi	lke					
lkh	Lakha	lkh					
lki	Laki	lki					
lkj	Remun	lkj					
lkl	Laeko-Libuat	lkl					
lkn	Lakon	lkn					
lko	Khayo	lko					
lkr	Päri	lkr					
lks	Kisa	lks					
lkt	Lakota	lkt					
lky	Lokoya	lky					
lla	Lala-Roba	lla					
llb	Lolo	llb					
llc	Lele (Guinea)	llc					
lld	Ladin	lld					Ladinisch
lle	Lele (Papua New Guinea)	lle					
llf	Hermit	llf					
llg	Lole	llg					
llh	Lamu	llh					
lli	Teke-Laali	lli					
llj	Ladji Ladji	llj					
llk	Lelak	llk					
lll	Lilau	lll					
llm	Lasalimu	llm					
lln	Lele (Chad)	lln					
llo	Khlor	llo					
llp	North Efate	llp					
llq	Lolak	llq					
lls	Lithuanian Sign Language	lls					
llu	Lau	llu					
llx	Lauan	llx					
lma	East Limba	lma					
lmb	Merei	lmb					
lmc	Limilngan	lmc					
lmd	Lumun	lmd					
lme	Pévé	lme					
lmf	South Lembata	lmf					
lmg	Lamogai	lmg					
lmh	Lambichhong	lmh					
lmi	Lombi	lmi					
lmj	West Lembata	lmj					
lmk	Lamkang	lmk					
lml	Hano	lml					
lmm	Lamam	lmm					
lmn	Lambadi	lmn					
lmo	Lombard	lmo					
lmp	Limbum	lmp					
lmq	Lamatuka	lmq					
lmr	Lamalera	lmr					
lmu	Lamenu	lmu					
lmv	Lomaiviti	lmv					
lmw	Lake Miwok	lmw					
lmx	Laimbue	lmx					
lmy	Lamboya	lmy					
lmz	Lumbee	lmz					
lna	Langbashe	lna					
lnb	Mbalanhu	lnb					
lnd	Lundayeh	lnd					
lng	Langobardic	lng					Lombardic
lnh	Lanoh	lnh					
lni	Daantanai'	lni					
lnj	Leningitij	lnj					
lnl	South Central Banda	lnl					
lnm	Langam	lnm					
lnn	Lorediakarkar	lnn					
lno	Lango (Sudan)	lno					
lns	Lamnso'	lns					
lnu	Longuda	lnu					
lnz	Lonzo	lnz					
loa	Loloda	loa					
lob	Lobi	lob					
loc	Inonhan	loc					
loe	Saluan	loe					
lof	Logol	lof					
log	Logo	log					
loh	Narim	loh					
loi	Loma (Côte d'Ivoire)	loi					
loj	Lou	loj					
lok	Loko	lok					
lol	Mongo	lol	lol	lol			mongo
lom	Loma (Liberia)	lom					
lon	Malawi Lomwe	lon					
loo	Lombo	loo					
lop	Lopa	lop					
loq	Lobala	loq					
lor	Téén	lor					
los	Loniu	los					
lot	Otuho	lot					
lou	Louisiana Creole French	lou					
lov	Lopi	lov					
low	Tampias Lobu	low					
lox	Loun	lox					
loy	Loke	loy					
loz	Lozi	loz	loz	loz			lozi
lpa	Lelepa	lpa					
lpe	Lepki	lpe					
lpn	Long Phuri Naga	lpn					
lpo	Lipo	lpo					
lpx	Lopit	lpx					
lra	Rara Bakati'	lra					
lrc	Northern Luri	lrc					
lre	Laurentian	lre					
lrg	Laragia	lrg					
lri	Marachi	lri					
lrk	Loarki	lrk					
lrl	Lari	lrl					
lrm	Marama	lrm					
lrn	Lorang	lrn					
lro	Laro	lro					
lrr	Southern Yamphu	lrr					
lrt	Larantuka Malay	lrt					
lrv	Larevat	lrv					
lrz	Lemerig	lrz					
lsa	Lasgerdi	lsa					
lsd	Lishana Deni	lsd					
lse	Lusengo	lse					
lsg	Lyons Sign Language	lsg					
lsh	Lish	lsh					
lsi	Lashi	lsi					
lsl	Latvian Sign Language	lsl					
lsm	Saamia	lsm					
lso	Laos Sign Language	lso					
lsp	Panamanian Sign Language	lsp					
lsr	Aruop	lsr					
lss	Lasi	lss					
lst	Trinidad and Tobago Sign Language	lst					
lsy	Mauritian Sign Language	lsy					
ltc	Late Middle Chinese	ltc					
ltg	Latgalian	ltg					
lti	Leti (Indonesia)	lti					
ltn	Latundê	ltn					
lto	Tsotso	lto					
lts	Tachoni	lts					
ltu	Latu	ltu					
ltz	Luxembourgish	ltz	ltz	ltz	lb	lb	Letzeburgesch;Luxemburgisch;luxembourgeois
lua	Luba-Lulua	lua	lua	lua			Tshiluba;luba-lulua
lub	Luba-Katanga	lub	lub	lub	lu	lu	luba-katanga
luc	Aringa	luc					
lud	Ludian	lud					
lue	Luvale	lue					
luf	Laua	luf					
lug	Ganda	lug	lug	lug	lg	lg	ganda;Luganda
lui	Luiseno	lui	lui	lui			luiseno
luj	Luna	luj					
luk	Lunanakha	luk					
lul	Olu'bo	lul					
lum	Luimbi	lum					
lun	Lunda	lun	lun	lun			lunda
luo	Luo (Kenya and Tanzania)	luo	luo	luo			Luo;luo (Kenya et Tanzanie)
lup	Lumbu	lup					
luq	Lucumi	luq					
lur	Laura	lur					
lus	Lushai	lus	lus	lus			lushai
lut	Lushootseed	lut					
luu	Lumba-Yakkha	luu					
luv	Luwati	luv					
luw	Luo (Cameroon)	luw					
luy	Luyia	luy					Luhya
luz	Southern Luri	luz					
lva	Maku'a	lva					
lvk	Lavukaleve	lvk					
lvs	Standard Latvian	lvs					
lvu	Levuka	lvu					
lwa	Lwalu	lwa					
lwe	Lewo Eleng	lwe					
lwg	Wanga	lwg					
lwh	White Lachi	lwh					
lwl	Eastern Lawa	lwl					
lwm	Laomian	lwm					
lwo	Luwo	lwo					
lwt	Lewotobi	lwt					
lww	Lewo	lww					
lya	Layakha	lya					
lyg	Lyngngam	lyg					
lyn	Luyana	lyn					
lzh	Literary Chinese	lzh					
lzl	Litzlitz	lzl					
lzn	Leinong Naga	lzn					
lzz	Laz	lzz					Lasisch
maa	San Jerónimo Tecóatl Mazatec	maa					
mab	Yutanduchi Mixtec	mab					
mad	Madurese	mad	mad	mad			madourais;Maduresisch
mae	Bo-Rukul	mae					
maf	Mafa	maf					
mag	Magahi	mag	mag	mag			magahi
mah	Marshallese	mah	mah	mah	mh	mh	Marshallisch;marshall
mai	Maithili	mai	mai	mai			maithili
maj	Jalapa De Díaz Mazatec	maj					
mak	Makasar	mak	mak	mak			makassar;Makassar
mal	Malayalam	mal	mal	mal	ml	ml	malayalam;Malajalam;Malabarisch
mam	Mam	mam					
man	Mandingo	man	man	man			mandingue
maq	Chiquihuitlán Mazatec	maq					
mar	Marathi	mar	mar	mar	mr	mr	Maratisch;Marati;marathe;Marathisch
mas	Masai	mas	mas	mas			Massai;Maasai;massaï
mat	San Francisco Matlatzinca	mat					
mau	Huautla Mazatec	mau					
mav	Sateré-Mawé	mav					
maw	Mampruli	maw					
max	North Moluccan Malay	max					
maz	Central Mazahua	maz					
mba	Higaonon	mba					
mbb	Western Bukidnon Manobo	mbb					
mbc	Macushi	mbc					
mbd	Dibabawon Manobo	mbd					
mbe	Molale	mbe					
mbf	Baba Malay	mbf					
mbh	Mangseng	mbh					
mbi	Ilianen Manobo	mbi					
mbj	Nadëb	mbj					
mbk	Malol	mbk					
mbl	Maxakalí	mbl					
mbm	Ombamba	mbm					
mbn	Macaguán	mbn					
mbo	Mbo (Cameroon)	mbo					
mbp	Malayo	mbp					
mbq	Maisin	mbq					
mbr	Nukak Makú	mbr					
mbs	Sarangani Manobo	mbs					
mbt	Matigsalug Manobo	mbt					
mbu	Mbula-Bwazza	mbu					
mbv	Mbulungish	mbv					
mbw	Maring	mbw					
mbx	Mari (East Sepik Province)	mbx					
mby	Memoni	mby					
mbz	Amoltepec Mixtec	mbz					
mca	Maca	mca					
mcb	Machiguenga	mcb					
mcc	Bitur	mcc					
mcd	Sharanahua	mcd					
mce	Itundujia Mixtec	mce					
mcf	Matsés	mcf					
mcg	Mapoyo	mcg					
mch	Maquiritari	mch					
mci	Mese	mci					
mcj	Mvanip	mcj					
mck	Mbunda	mck					
mcl	Macaguaje	mcl					
mcm	Malaccan Creole Portuguese	mcm					
mcn	Masana	mcn					
mco	Coatlán Mixe	mco					
mcp	Makaa	mcp					
mcq	Ese	mcq					
mcr	Menya	mcr					
mcs	Mambai	mcs					
mct	Mengisa	mct					
mcu	Cameroon Mambila	mcu					
mcv	Minanibai	mcv					
mcw	Mawa (Chad)	mcw					
mcx	Mpiemo	mcx					
mcy	South Watut	mcy					
mcz	Mawan	mcz					
mda	Mada (Nigeria)	mda					
mdb	Morigi	mdb					
mdc	Male (Papua New Guinea)	mdc					
mdd	Mbum	mdd					
mde	Maba (Chad)	mde					
mdf	Moksha	mdf	mdf	mdf			Mordwinisch, Mokscha-;Mokscha(nisch);moksa
mdg	Massalat	mdg					
mdh	Maguindanaon	mdh					
mdi	Mamvu	mdi					
mdj	Mangbetu	mdj					
mdk	Mangbutu	mdk					
mdl	Maltese Sign Language	mdl					
mdm	Mayogo	mdm					
mdn	Mbati	mdn					
mdp	Mbala	mdp					
mdq	Mbole	mdq					
mdr	Mandar	mdr	mdr	mdr			mandar
mds	Maria (Papua New Guinea)	mds					
mdt	Mbere	mdt					
mdu	Mboko	mdu					
mdv	Santa Lucía Monteverde Mixtec	mdv					
mdw	Mbosi	mdw					
mdx	Dizin	mdx					
mdy	Male (Ethiopia)	mdy					
mdz	Suruí Do Pará	mdz					
mea	Menka	mea					
meb	Ikobi	meb					
mec	Mara	mec					
med	Melpa	med					
mee	Mengen	mee					
mef	Megam	mef					
meg	Mea	meg					
meh	Southwestern Tlaxiaco Mixtec	meh					
mei	Midob	mei					
mej	Meyah	mej					
mek	Mekeo	mek					
mel	Central Melanau	mel					
mem	Mangala	mem					
men	Mende (Sierra Leone)	men	men	men			mendé;Mende
meo	Kedah Malay	meo					
mep	Miriwung	mep					
meq	Merey	meq					
mer	Meru	mer					
mes	Masmaje	mes					
met	Mato	met					
meu	Motu	meu					
mev	Mann	mev					
mew	Maaka	mew					
mey	Hassaniyya	mey					
mez	Menominee	mez					
mfa	Pattani Malay	mfa					
mfb	Bangka	mfb					
mfc	Mba	mfc					
mfd	Mendankwe-Nkwen	mfd					
mfe	Morisyen	mfe					
mff	Naki	mff					
mfg	Mixifore	mfg					
mfh	Matal	mfh					
mfi	Wandala	mfi					
mfj	Mefele	mfj					
mfk	North Mofu	mfk					
mfl	Putai	mfl					
mfm	Marghi South	mfm					
mfn	Cross River Mbembe	mfn					
mfo	Mbe	mfo					
mfp	Makassar Malay	mfp					
mfq	Moba	mfq					
mfr	Marithiel	mfr					
mfs	Mexican Sign Language	mfs					
mft	Mokerang	mft					
mfu	Mbwela	mfu					
mfv	Mandjak	mfv					
mfw	Mulaha	mfw					
mfx	Melo	mfx					
mfy	Mayo	mfy					
mfz	Mabaan	mfz					
mga	Middle Irish	mga	mga	mga			Irish, Middle (900-1200);irlandais moyen (900-1200);Middle Irish (900-1200)
mgb	Mararit	mgb					
mgc	Morokodo	mgc					
mgd	Moru	mgd					
mge	Mango	mge					
mgf	Maklew	mgf					
mgg	Mpumpong	mgg					
mgh	Makhuwa-Meetto	mgh					
mgi	Lijili	mgi					
mgj	Abureni	mgj					
mgk	Mawes	mgk					
mgl	Maleu-Kilenge	mgl					
mgm	Mambae	mgm					
mgn	Mbangi	mgn					
mgo	Meta'	mgo					
mgp	Eastern Magar	mgp					
mgq	Malila	mgq					
mgr	Mambwe-Lungu	mgr					
mgs	Manda (Tanzania)	mgs					
mgt	Mongol	mgt					
mgu	Mailu	mgu					
mgv	Matengo	mgv					
mgw	Matumbi	mgw					
mgy	Mbunga	mgy					
mgz	Mbugwe	mgz					
mha	Manda (India)	mha					
mhb	Mahongwe	mhb					
mhc	Mocho	mhc					
mhd	Mbugu	mhd					
mhe	Besisi	mhe					
mhf	Mamaa	mhf					
mhg	Margu	mhg					
mhh	Maskoy Pidgin	mhh					
mhi	Ma'di	mhi					
mhj	Mogholi	mhj					
mhk	Mungaka	mhk					
mhl	Mauwake	mhl					
mhm	Makhuwa-Moniga	mhm					
mhn	Mócheno	mhn					
mho	Mashi (Zambia)	mho					
mhp	Balinese Malay	mhp					
mhq	Mandan	mhq					
mhr	Eastern Mari	mhr					
mhs	Buru (Indonesia)	mhs					
mht	Mandahuaca	mht					
mhu	Digaro-Mishmi	mhu					
mhw	Mbukushu	mhw					
mhx	Maru	mhx					
mhy	Ma'anyan	mhy					
mhz	Mor (Mor Islands)	mhz					
mia	Miami	mia					
mib	Atatláhuca Mixtec	mib					
mic	Mi'kmaq	mic	mic	mic			Micmac;mi'kmaq;micmac
mid	Mandaic	mid					
mie	Ocotepec Mixtec	mie					
mif	Mofu-Gudur	mif					
mig	San Miguel El Grande Mixtec	mig					
mih	Chayuco Mixtec	mih					
mii	Chigmecatitlán Mixtec	mii					
mij	Abar	mij					
mik	Mikasuki	mik					
mil	Peñoles Mixtec	mil					
mim	Alacatlatzala Mixtec	mim					
min	Minangkabau	min	min	min			minangkabau
mio	Pinotepa Nacional Mixtec	mio					
mip	Apasco-Apoala Mixtec	mip					
miq	Mískito	miq					Miskito
mir	Isthmus Mixe	mir					
mis	Uncoded languages	mis	mis	mis			langues non codées
mit	Southern Puebla Mixtec	mit					
miu	Cacaloxtepec Mixtec	miu					
miw	Akoye	miw					
mix	Mixtepec Mixtec	mix					
miy	Ayutla Mixtec	miy					
miz	Coatzospan Mixtec	miz					
mjc	San Juan Colorado Mixtec	mjc					
mjd	Northwest Maidu	mjd					
mje	Muskum	mje					
mjg	Tu	mjg					
mjh	Mwera (Nyasa)	mjh					
mji	Kim Mun	mji					
mjj	Mawak	mjj					
mjk	Matukar	mjk					
mjl	Mandeali	mjl					
mjm	Medebur	mjm					
mjn	Ma (Papua New Guinea)	mjn					
mjo	Malankuravan	mjo					
mjp	Malapandaram	mjp					
mjq	Malaryan	mjq					
mjr	Malavedan	mjr					
mjs	Miship	mjs					
mjt	Sauria Paharia	mjt					
mju	Manna-Dora	mju					
mjv	Mannan	mjv					
mjw	Karbi	mjw					
mjx	Mahali	mjx					
mjy	Mahican	mjy					
mjz	Majhi	mjz					
mka	Mbre	mka					
mkb	Mal Paharia	mkb					
mkc	Siliput	mkc					
mkd	Macedonian	mkd	mac	mkd	mk	ma;mac;mk	macédonien;Makedonisch;Mazedonisch
mke	Mawchi	mke					
mkf	Miya	mkf					
mkg	Mak (China)	mkg					
mki	Dhatki	mki					
mkj	Mokilese	mkj					
mkk	Byep	mkk					
mkl	Mokole	mkl					
mkm	Moklen	mkm					
mkn	Kupang Malay	mkn					
mko	Mingang Doso	mko					
mkp	Moikodi	mkp					
mkq	Bay Miwok	mkq					
mkr	Malas	mkr					
mks	Silacayoapan Mixtec	mks					
mkt	Vamale	mkt					
mku	Konyanka Maninka	mku					
mkv	Mafea	mkv					
mkw	Kituba (Congo)	mkw					
mkx	Kinamiging Manobo	mkx					
mky	East Makian	mky					
mkz	Makasae	mkz					
mla	Malo	mla					
mlb	Mbule	mlb					
mlc	Cao Lan	mlc					
mld	Malakhel	mld					
mle	Manambu	mle					
mlf	Mal	mlf					
mlg	Malagasy	mlg	mlg	mlg	mg	mg	Madagassisch;malgache;Madagassisch/Malagasy
mlh	Mape	mlh					
mli	Malimpung	mli					
mlj	Miltu	mlj					
mlk	Ilwana	mlk					
mll	Malua Bay	mll					
mlm	Mulam	mlm					
mln	Malango	mln					
mlo	Mlomp	mlo					
mlp	Bargam	mlp					
mlq	Western Maninkakan	mlq					
mlr	Vame	mlr					
mls	Masalit	mls					
mlt	Maltese	mlt	mlt	mlt	mt	mt	Maltesisch;maltais
mlu	To'abaita	mlu					
mlv	Motlav	mlv					
mlw	Moloko	mlw					
mlx	Malfaxal	mlx					
mlz	Malaynon	mlz					
mma	Mama	mma					
mmb	Momina	mmb					
mmc	Michoacán Mazahua	mmc					
mmd	Maonan	mmd					
mme	Mae	mme					
mmf	Mundat	mmf					
mmg	North Ambrym	mmg					
mmh	Mehináku	mmh					
mmi	Musar	mmi					
mmj	Majhwar	mmj					
mmk	Mukha-Dora	mmk					
mml	Man Met	mml					
mmm	Maii	mmm					
mmn	Mamanwa	mmn					
mmo	Mangga Buang	mmo					
mmp	Siawi	mmp					Musan
mmq	Musak	mmq					
mmr	Western Xiangxi Miao	mmr					
mmt	Malalamai	mmt					
mmu	Mmaala	mmu					
mmv	Miriti	mmv					
mmw	Emae	mmw					
mmx	Madak	mmx					
mmy	Migaama	mmy					
mmz	Mabaale	mmz					
mna	Mbula	mna					
mnb	Muna	mnb					
mnc	Manchu	mnc	mnc	mnc			Mandschurisch;mandchou
mnd	Mondé	mnd					
mne	Naba	mne					
mnf	Mundani	mnf					
mng	Eastern Mnong	mng					
mnh	Mono (Democratic Republic of Congo)	mnh					
mni	Manipuri	mni	mni	mni			manipuri
mnj	Munji	mnj					
mnk	Mandinka	mnk					
mnl	Tiale	mnl					
mnm	Mapena	mnm					
mnn	Southern Mnong	mnn					
mnp	Min Bei Chinese	mnp					Min Bei
mnq	Minriq	mnq					
mnr	Mono (USA)	mnr					
mns	Mansi	mns					Mansisch
mnt	Maykulan	mnt					
mnu	Mer	mnu					
mnv	Rennell-Bellona	mnv					
mnw	Mon	mnw					
mnx	Manikion	mnx					
mny	Manyawa	mny					
mnz	Moni	mnz					
moa	Mwan	moa					
moc	Mocoví	moc					
mod	Mobilian	mod					
moe	Montagnais	moe					
mog	Mongondow	mog					
moh	Mohawk	moh	moh	moh			mohawk
moi	Mboi	moi					
moj	Monzombo	moj					
mok	Morori	mok					
mom	Mangue	mom					
mon	Mongolian	mon	mon	mon	mn	mn	mongol;Mongolisch;Neumongolisch
moo	Monom	moo					
mop	Mopán Maya	mop					Mopán
moq	Mor (Bomberai Peninsula)	moq					
mor	Moro	mor					
mos	Mossi	mos	mos	mos			More;moré
mot	Barí	mot					
mou	Mogum	mou					
mov	Mohave	mov					
mow	Moi (Congo)	mow					
mox	Molima	mox					
moy	Shekkacho	moy					
moz	Mukulu	moz					
mpa	Mpoto	mpa					
mpb	Mullukmulluk	mpb					
mpc	Mangarayi	mpc					
mpd	Machinere	mpd					
mpe	Majang	mpe					
mpg	Marba	mpg					
mph	Maung	mph					
mpi	Mpade	mpi					
mpj	Martu Wangka	mpj					
mpk	Mbara (Chad)	mpk					
mpl	Middle Watut	mpl					
mpm	Yosondúa Mixtec	mpm					
mpn	Mindiri	mpn					
mpo	Miu	mpo					
mpp	Migabac	mpp					
mpq	Matís	mpq					
mpr	Vangunu	mpr					
mps	Dadibi	mps					
mpt	Mian	mpt					
mpu	Makuráp	mpu					
mpv	Mungkip	mpv					
mpw	Mapidian	mpw					
mpx	Misima-Panaeati	mpx					
mpy	Mapia	mpy					
mpz	Mpi	mpz					
mqa	Maba (Indonesia)	mqa					
mqb	Mbuko	mqb					
mqc	Mangole	mqc					
mqe	Matepi	mqe					
mqf	Momuna	mqf					
mqg	Kota Bangun Kutai Malay	mqg					
mqh	Tlazoyaltepec Mixtec	mqh					
mqi	Mariri	mqi					
mqj	Mamasa	mqj					
mqk	Rajah Kabunsuwan Manobo	mqk					
mql	Mbelime	mql					
mqm	South Marquesan	mqm					
mqn	Moronene	mqn					
mqo	Modole	mqo					
mqp	Manipa	mqp					
mqq	Minokok	mqq					
mqr	Mander	mqr					
mqs	West Makian	mqs					
mqt	Mok	mqt					
mqu	Mandari	mqu					
mqv	Mosimo	mqv					
mqw	Murupi	mqw					
mqx	Mamuju	mqx					
mqy	Manggarai	mqy					
mqz	Pano	mqz					
mra	Mlabri	mra					
mrb	Marino	mrb					
mrc	Maricopa	mrc					
mrd	Western Magar	mrd					
mre	Martha's Vineyard Sign Language	mre					
mrf	Elseng	mrf					
mrg	Mising	mrg					
mrh	Mara Chin	mrh					
mri	Maori	mri	mao	mri	mi	mao;mi	maori;Maorisch
mrj	Western Mari	mrj					
mrk	Hmwaveke	mrk					
mrl	Mortlockese	mrl					
mrm	Merlav	mrm					
mrn	Cheke Holo	mrn					
mro	Mru	mro					
mrp	Morouas	mrp					
mrq	North Marquesan	mrq					
mrr	Maria (India)	mrr					
mrs	Maragus	mrs					
mrt	Marghi Central	mrt					
mru	Mono (Cameroon)	mru					
mrv	Mangareva	mrv					Mangarevan
mrw	Maranao	mrw					
mrx	Maremgi	mrx					
mry	Mandaya	mry					
mrz	Marind	mrz					
msa	Malay	msa	may	msa	ms	ms;may;mst	Malaiisch;Malay (macrolanguage);Malaiisch/Malaysisch;malais
msb	Masbatenyo	msb					
msc	Sankaran Maninka	msc					
msd	Yucatec Maya Sign Language	msd					
mse	Musey	mse					
msf	Mekwei	msf					
msg	Moraid	msg					
msh	Masikoro Malagasy	msh					
msi	Sabah Malay	msi					
msj	Ma (Democratic Republic of Congo)	msj					
msk	Mansaka	msk					
msl	Molof	msl					
msm	Agusan Manobo	msm					
msn	Vurës	msn					
mso	Mombum	mso					
msp	Maritsauá	msp					
msq	Caac	msq					
msr	Mongolian Sign Language	msr					
mss	West Masela	mss					
msu	Musom	msu					
msv	Maslam	msv					
msw	Mansoanka	msw					
msx	Moresada	msx					
msy	Aruamu	msy					
msz	Momare	msz					
mta	Cotabato Manobo	mta					
mtb	Anyin Morofo	mtb					
mtc	Munit	mtc					
mtd	Mualang	mtd					
mte	Mono (Solomon Islands)	mte					
mtf	Murik (Papua New Guinea)	mtf					
mtg	Una	mtg					
mth	Munggui	mth					
mti	Maiwa (Papua New Guinea)	mti					
mtj	Moskona	mtj					
mtk	Mbe'	mtk					
mtl	Montol	mtl					
mtm	Mator	mtm					
mtn	Matagalpa	mtn					
mto	Totontepec Mixe	mto					
mtp	Wichí Lhamtés Nocten	mtp					
mtq	Muong	mtq					
mtr	Mewari	mtr					
mts	Yora	mts					
mtt	Mota	mtt					
mtu	Tututepec Mixtec	mtu					
mtv	Asaro'o	mtv					
mtw	Southern Binukidnon	mtw					
mtx	Tidaá Mixtec	mtx					
mty	Nabi	mty					
mua	Mundang	mua					
mub	Mubi	mub					
muc	Mbu'	muc					
mud	Mednyj Aleut	mud					
mue	Media Lengua	mue					
mug	Musgu	mug					
muh	Mündü	muh					
mui	Musi	mui					
muj	Mabire	muj					
muk	Mugom	muk					
mul	Multiple languages	mul	mul	mul			multilingue
mum	Maiwala	mum					
muo	Nyong	muo					
mup	Malvi	mup					
muq	Eastern Xiangxi Miao	muq					
mur	Murle	mur					
mus	Creek	mus	mus	mus			Creek/ Muskogee;Muskogee / Creek;muskogee;Muskogisch / Creek
mut	Western Muria	mut					
muu	Yaaku	muu					
muv	Muthuvan	muv					
mux	Bo-Ung	mux					
muy	Muyang	muy					
muz	Mursi	muz					
mva	Manam	mva					
mvb	Mattole	mvb					
mvd	Mamboru	mvd					
mve	Marwari (Pakistan)	mve					
mvf	Peripheral Mongolian	mvf					
mvg	Yucuañe Mixtec	mvg					
mvh	Mulgi	mvh					
mvi	Miyako	mvi					
mvk	Mekmek	mvk					
mvl	Mbara (Australia)	mvl					
mvm	Muya	mvm					
mvn	Minaveha	mvn					
mvo	Marovo	mvo					
mvp	Duri	mvp					
mvq	Moere	mvq					
mvr	Marau	mvr					
mvs	Massep	mvs					
mvt	Mpotovoro	mvt					
mvu	Marfa	mvu					
mvv	Tagal Murut	mvv					
mvw	Machinga	mvw					
mvx	Meoswar	mvx					
mvy	Indus Kohistani	mvy					
mvz	Mesqan	mvz					
mwa	Mwatebu	mwa					
mwb	Juwal	mwb					
mwc	Are	mwc					
mwd	Mudbura	mwd					
mwe	Mwera (Chimwera)	mwe					
mwf	Murrinh-Patha	mwf					
mwg	Aiklep	mwg					
mwh	Mouk-Aria	mwh					
mwi	Labo	mwi					
mwj	Maligo	mwj					
mwk	Kita Maninkakan	mwk					
mwl	Mirandese	mwl	mwl	mwl			mirandais
mwm	Sar	mwm					
mwn	Nyamwanga	mwn					
mwo	Central Maewo	mwo					
mwp	Kala Lagaw Ya	mwp					
mwq	Mün Chin	mwq					
mwr	Marwari	mwr	mwr	mwr			marvari
mws	Mwimbi-Muthambi	mws					
mwt	Moken	mwt					
mwu	Mittu	mwu					
mwv	Mentawai	mwv					
mww	Hmong Daw	mww					
mwx	Mediak	mwx					
mwy	Mosiro	mwy					
mwz	Moingi	mwz					
mxa	Northwest Oaxaca Mixtec	mxa					
mxb	Tezoatlán Mixtec	mxb					
mxc	Manyika	mxc					
mxd	Modang	mxd					
mxe	Mele-Fila	mxe					
mxf	Malgbe	mxf					
mxg	Mbangala	mxg					
mxh	Mvuba	mxh					
mxi	Mozarabic	mxi					
mxj	Miju-Mishmi	mxj					
mxk	Monumbo	mxk					
mxl	Maxi Gbe	mxl					
mxm	Meramera	mxm					
mxn	Moi (Indonesia)	mxn					
mxo	Mbowe	mxo					
mxp	Tlahuitoltepec Mixe	mxp					
mxq	Juquila Mixe	mxq					
mxr	Murik (Malaysia)	mxr					
mxs	Huitepec Mixtec	mxs					
mxt	Jamiltepec Mixtec	mxt					
mxu	Mada (Cameroon)	mxu					
mxv	Metlatónoc Mixtec	mxv					
mxw	Namo	mxw					
mxx	Mahou	mxx					
mxy	Southeastern Nochixtlán Mixtec	mxy					
mxz	Central Masela	mxz					
mya	Burmese	mya	bur	mya	my	bur;my	Myanmarisch/Birmanisch;Birmanisch/Burmesisch;birman
myb	Mbay	myb					
myc	Mayeka	myc					
myd	Maramba	myd					
mye	Myene	mye					
myf	Bambassi	myf					
myg	Manta	myg					
myh	Makah	myh					
myi	Mina (India)	myi					
myj	Mangayat	myj					
myk	Mamara Senoufo	myk					
myl	Moma	myl					
mym	Me'en	mym					
myo	Anfillo	myo					
myp	Pirahã	myp					
myq	Forest Maninka	myq					
myr	Muniche	myr					
mys	Mesmes	mys					
myu	Mundurukú	myu					
myv	Erzya	myv	myv	myv			Ersänisch;Ersa-Mordwinisch;erza;Ersja;Mordwinisch, Ersa-
myw	Muyuw	myw					
myx	Masaaba	myx					
myy	Macuna	myy					
myz	Classical Mandaic	myz					
mza	Santa María Zacatepec Mixtec	mza					
mzb	Tumzabt	mzb					
mzc	Madagascar Sign Language	mzc					
mzd	Malimba	mzd					
mze	Morawa	mze					
mzg	Monastic Sign Language	mzg					
mzh	Wichí Lhamtés Güisnay	mzh					
mzi	Ixcatlán Mazatec	mzi					
mzj	Manya	mzj					
mzk	Nigeria Mambila	mzk					
mzl	Mazatlán Mixe	mzl					
mzm	Mumuye	mzm					
mzn	Mazanderani	mzn					
mzo	Matipuhy	mzo					
mzp	Movima	mzp					
mzq	Mori Atas	mzq					
mzr	Marúbo	mzr					
mzs	Macanese	mzs					
mzt	Mintil	mzt					
mzu	Inapang	mzu					
mzv	Manza	mzv					
mzw	Deg	mzw					
mzx	Mawayana	mzx					
mzy	Mozambican Sign Language	mzy					
mzz	Maiadomu	mzz					
naa	Namla	naa					
nab	Southern Nambikuára	nab					
nac	Narak	nac					
nad	Nijadali	nad					
nae	Naka'ela	nae					
naf	Nabak	naf					
nag	Naga Pidgin	nag					
naj	Nalu	naj					
nak	Nakanai	nak					
nal	Nalik	nal					
nam	Ngan'gityemerri	nam					
nan	Min Nan Chinese	nan				zh-min-nan	Taiwanisch;Minnan;Min Nan;Chinesisch (Min-Nan)
nao	Naaba	nao					
nap	Neapolitan	nap	nap	nap			napolitain
naq	Nama (Namibia)	naq					Nama
nar	Iguta	nar					
nas	Naasioi	nas					
nat	Hungworo	nat					
nau	Nauru	nau	nau	nau	na	na	Nauruan;nauruan;Nauruisch
nav	Navajo	nav	nav	nav	nv	nv	Navaho;navaho
naw	Nawuri	naw					
nax	Nakwi	nax					
nay	Narrinyeri	nay					
naz	Coatepec Nahuatl	naz					
nba	Nyemba	nba					
nbb	Ndoe	nbb					
nbc	Chang Naga	nbc					
nbd	Ngbinda	nbd					
nbe	Konyak Naga	nbe					
nbg	Nagarchal	nbg					
nbh	Ngamo	nbh					
nbi	Mao Naga	nbi					
nbj	Ngarinman	nbj					
nbk	Nake	nbk					
nbl	South Ndebele	nbl	nbl	nbl	nr	nr	ndébélé du Sud;Ndebele, South
nbm	Ngbaka Ma'bo	nbm					
nbn	Kuri	nbn					
nbo	Nkukoli	nbo					
nbp	Nnam	nbp					
nbq	Nggem	nbq					
nbr	Numana-Nunku-Gbantu-Numbu	nbr					
nbs	Namibian Sign Language	nbs					
nbt	Na	nbt					
nbu	Rongmei Naga	nbu					
nbv	Ngamambo	nbv					
nbw	Southern Ngbandi	nbw					
nbx	Ngura	nbx					
nby	Ningera	nby					
nca	Iyo	nca					
ncb	Central Nicobarese	ncb					
ncc	Ponam	ncc					
ncd	Nachering	ncd					
nce	Yale	nce					
ncf	Notsi	ncf					
ncg	Nisga'a	ncg					
nch	Central Huasteca Nahuatl	nch					
nci	Classical Nahuatl	nci					
ncj	Northern Puebla Nahuatl	ncj					
nck	Nakara	nck					
ncl	Michoacán Nahuatl	ncl					
ncm	Nambo	ncm					
ncn	Nauna	ncn					
nco	Sibe	nco					
ncp	Ndaktup	ncp					
ncr	Ncane	ncr					
ncs	Nicaraguan Sign Language	ncs					
nct	Chothe Naga	nct					
ncu	Chumburung	ncu					
ncx	Central Puebla Nahuatl	ncx					
ncz	Natchez	ncz					
nda	Ndasa	nda					
ndb	Kenswei Nsei	ndb					
ndc	Ndau	ndc					
ndd	Nde-Nsele-Nta	ndd					
nde	North Ndebele	nde	nde	nde	nd	nd	Ndebele/Nord-Ndebele;ndébélé du Nord;Ndebele, North
ndf	Nadruvian	ndf					
ndg	Ndengereko	ndg					
ndh	Ndali	ndh					
ndi	Samba Leko	ndi					
ndj	Ndamba	ndj					
ndk	Ndaka	ndk					
ndl	Ndolo	ndl					
ndm	Ndam	ndm					
ndn	Ngundi	ndn					
ndo	Ndonga	ndo	ndo	ndo	ng	ng	ndonga
ndp	Ndo	ndp					
ndq	Ndombe	ndq					
ndr	Ndoola	ndr					
nds	Low German	nds	nds	nds			bas allemand;Saxon, Low;allemand, bas;German, Low;Dutch Low Saxon;saxon, bas;Low Saxon;bas saxon;Plattdeutsch;Niedersächsisch
ndt	Ndunga	ndt					
ndu	Dugun	ndu					
ndv	Ndut	ndv					
ndw	Ndobo	ndw					
ndx	Nduga	ndx					
ndy	Lutos	ndy					
ndz	Ndogo	ndz					
nea	Eastern Ngad'a	nea					
neb	Toura (Côte d'Ivoire)	neb					
nec	Nedebang	nec					
ned	Nde-Gbite	ned					
nee	Nêlêmwa-Nixumwak	nee					
nef	Nefamese	nef					
neg	Negidal	neg					
neh	Nyenkha	neh					
nei	Neo-Hittite	nei					
nej	Neko	nej					
nek	Neku	nek					
nem	Nemi	nem					
nen	Nengone	nen					
neo	Ná-Meo	neo					
nep	Nepali	nep	nep	nep	ne	ne	népalais;Nepalesisch;Nepali (macrolanguage)
neq	North Central Mixe	neq					
ner	Yahadian	ner					
nes	Bhoti Kinnauri	nes					
net	Nete	net					
neu	Neo	neu					
nev	Nyaheun	nev					
new	Newari	new	new	new			Nepal Bhasa;newari;nepal bhasa
nex	Neme	nex					
ney	Neyo	ney					
nez	Nez Perce	nez					
nfa	Dhao	nfa					
nfd	Ahwai	nfd					
nfl	Ayiwo	nfl					
nfr	Nafaanra	nfr					
nfu	Mfumte	nfu					
nga	Ngbaka	nga					
ngb	Northern Ngbandi	ngb					
ngc	Ngombe (Democratic Republic of Congo)	ngc					
ngd	Ngando (Central African Republic)	ngd					
nge	Ngemba	nge					
ngg	Ngbaka Manza	ngg					
ngh	N/u	ngh					
ngi	Ngizim	ngi					
ngj	Ngie	ngj					
ngk	Ngalkbun	ngk					
ngl	Lomwe	ngl					
ngm	Ngatik Men's Creole	ngm					
ngn	Ngwo	ngn					
ngo	Ngoni	ngo					
ngp	Ngulu	ngp					
ngq	Ngurimi	ngq					
ngr	Engdewu	ngr					
ngs	Gvoko	ngs					
ngt	Ngeq	ngt					
ngu	Guerrero Nahuatl	ngu					
ngv	Nagumi	ngv					
ngw	Ngwaba	ngw					
ngx	Nggwahyi	ngx					
ngy	Tibea	ngy					
ngz	Ngungwel	ngz					
nha	Nhanda	nha					
nhb	Beng	nhb					
nhc	Tabasco Nahuatl	nhc					
nhd	Chiripá	nhd					
nhe	Eastern Huasteca Nahuatl	nhe					
nhf	Nhuwala	nhf					
nhg	Tetelcingo Nahuatl	nhg					
nhh	Nahari	nhh					
nhi	Zacatlán-Ahuacatlán-Tepetzintla Nahuatl	nhi					
nhk	Isthmus-Cosoleacaque Nahuatl	nhk					
nhm	Morelos Nahuatl	nhm					
nhn	Central Nahuatl	nhn					
nho	Takuu	nho					
nhp	Isthmus-Pajapan Nahuatl	nhp					
nhq	Huaxcaleca Nahuatl	nhq					
nhr	Naro	nhr					
nht	Ometepec Nahuatl	nht					
nhu	Noone	nhu					
nhv	Temascaltepec Nahuatl	nhv					
nhw	Western Huasteca Nahuatl	nhw					
nhx	Isthmus-Mecayapan Nahuatl	nhx					
nhy	Northern Oaxaca Nahuatl	nhy					
nhz	Santa María La Alta Nahuatl	nhz					
nia	Nias	nia	nia	nia			nias
nib	Nakame	nib					
nid	Ngandi	nid					
nie	Niellim	nie					
nif	Nek	nif					
nig	Ngalakan	nig					
nih	Nyiha (Tanzania)	nih					
nii	Nii	nii					
nij	Ngaju	nij					
nik	Southern Nicobarese	nik					
nil	Nila	nil					
nim	Nilamba	nim					
nin	Ninzo	nin					
nio	Nganasan	nio					
niq	Nandi	niq					
nir	Nimboran	nir					
nis	Nimi	nis					
nit	Southeastern Kolami	nit					
niu	Niuean	niu	niu	niu			niué;Niueanisch
niv	Gilyak	niv					
niw	Nimo	niw					
nix	Hema	nix					
niy	Ngiti	niy					
niz	Ningil	niz					
nja	Nzanyi	nja					
njb	Nocte Naga	njb					
njd	Ndonde Hamba	njd					
njh	Lotha Naga	njh					
nji	Gudanji	nji					
njj	Njen	njj					
njl	Njalgulgule	njl					
njm	Angami Naga	njm					
njn	Liangmai Naga	njn					
njo	Ao Naga	njo					
njr	Njerep	njr					
njs	Nisa	njs					
njt	Ndyuka-Trio Pidgin	njt					
nju	Ngadjunmaya	nju					
njx	Kunyi	njx					
njy	Njyem	njy					
njz	Nyishi	njz					
nka	Nkoya	nka					
nkb	Khoibu Naga	nkb					
nkc	Nkongho	nkc					
nkd	Koireng	nkd					
nke	Duke	nke					
nkf	Inpui Naga	nkf					
nkg	Nekgini	nkg					
nkh	Khezha Naga	nkh					
nki	Thangal Naga	nki					
nkj	Nakai	nkj					
nkk	Nokuku	nkk					
nkm	Namat	nkm					
nkn	Nkangala	nkn					
nko	Nkonya	nko					
nkp	Niuatoputapu	nkp					
nkq	Nkami	nkq					
nkr	Nukuoro	nkr					
nks	North Asmat	nks					
nkt	Nyika (Tanzania)	nkt					
nku	Bouna Kulango	nku					
nkv	Nyika (Malawi and Zambia)	nkv					
nkw	Nkutu	nkw					
nkx	Nkoroo	nkx					
nkz	Nkari	nkz					
nla	Ngombale	nla					
nlc	Nalca	nlc					
nld	Dutch	nld	dut	nld	nl	dut;nl	Niederländisch/Holländisch;flamand;Niederländisch;néerlandais;Holländisch;Flemish
nle	East Nyala	nle					
nlg	Gela	nlg					
nli	Grangali	nli					
nlj	Nyali	nlj					
nlk	Ninia Yali	nlk					
nll	Nihali	nll					
nlo	Ngul	nlo					
nlr	Ngarla	nlr					
nlu	Nchumbulu	nlu					
nlv	Orizaba Nahuatl	nlv					
nlx	Nahali	nlx					
nly	Nyamal	nly					
nlz	Nalögo	nlz					
nma	Maram Naga	nma					
nmb	Big Nambas	nmb					
nmc	Ngam	nmc					
nmd	Ndumu	nmd					
nme	Mzieme Naga	nme					
nmf	Tangkhul Naga (India)	nmf					
nmg	Kwasio	nmg					
nmh	Monsang Naga	nmh					
nmi	Nyam	nmi					
nmj	Ngombe (Central African Republic)	nmj					
nmk	Namakura	nmk					
nml	Ndemli	nml					
nmm	Manangba	nmm					
nmn	!Xóõ	nmn					ǃXóõ
nmo	Moyon Naga	nmo					
nmp	Nimanbur	nmp					
nmq	Nambya	nmq					
nmr	Nimbari	nmr					
nms	Letemboi	nms					
nmt	Namonuito	nmt					
nmu	Northeast Maidu	nmu					
nmv	Ngamini	nmv					
nmw	Nimoa	nmw					
nmx	Nama (Papua New Guinea)	nmx					
nmy	Namuyi	nmy					
nmz	Nawdm	nmz					
nna	Nyangumarta	nna					
nnb	Nande	nnb					
nnc	Nancere	nnc					
nnd	West Ambae	nnd					
nne	Ngandyera	nne					
nnf	Ngaing	nnf					
nng	Maring Naga	nng					
nnh	Ngiemboon	nnh					
nni	North Nuaulu	nni					
nnj	Nyangatom	nnj					
nnk	Nankina	nnk					
nnl	Northern Rengma Naga	nnl					
nnm	Namia	nnm					
nnn	Ngete	nnn					
nno	Norwegian Nynorsk	nno	nno	nno	nn	nn	nynorsk, norvégien;Neunorwegisch (Nynorsk);norvégien nynorsk;Norwegian (nynorsk);Norwegisch Nynorsk;Nynorsk;Nynorsk, Norwegian
nnp	Wancho Naga	nnp					
nnq	Ngindo	nnq					
nnr	Narungga	nnr					
nns	Ningye	nns					
nnt	Nanticoke	nnt					
nnu	Dwang	nnu					
nnv	Nugunu (Australia)	nnv					
nnw	Southern Nuni	nnw					
nnx	Ngong	nnx					
nny	Nyangga	nny					
nnz	Nda'nda'	nnz					
noa	Woun Meu	noa					
nob	Norwegian Bokmål	nob	nob	nob	nb	nb	Norwegian (Bokmål);norvégien bokmål;Bokmål, Norwegian
noc	Nuk	noc					
nod	Northern Thai	nod					
noe	Nimadi	noe					
nof	Nomane	nof					
nog	Nogai	nog	nog	nog			nogaï;nogay
noh	Nomu	noh					
noi	Noiri	noi					
noj	Nonuya	noj					
nok	Nooksack	nok					
nom	Nocamán	nom					
non	Old Norse	non	non	non			norrois, vieux;Altnordisch;Norse, Old
nop	Numanggang	nop					
noq	Ngongo	noq					
nor	Norwegian	nor	nor	nor	no	no	norvégien;Norwegisch;Bokmål
nos	Eastern Nisu	nos					
not	Nomatsiguenga	not					
nou	Ewage-Notu	nou					
nov	Novial	nov					
now	Nyambo	now					
noy	Noy	noy					
noz	Nayi	noz					
npa	Nar Phu	npa					
npb	Nupbikha	npb					
npg	Ponyo-Gongwang Naga	npg					
nph	Phom Naga	nph					
npi	Nepali (individual language)	npi					
npl	Southeastern Puebla Nahuatl	npl					
npn	Mondropolon	npn					
npo	Pochuri Naga	npo					
nps	Nipsan	nps					
npu	Puimei Naga	npu					
npy	Napu	npy					
nqg	Southern Nago	nqg					
nqk	Kura Ede Nago	nqk					
nqm	Ndom	nqm					
nqn	Nen	nqn					
nqo	N'Ko	nqo	nqo	nqo			n'ko
nqy	Akyaung Ari Naga	nqy					
nra	Ngom	nra					
nrb	Nara	nrb					
nrc	Noric	nrc					
nre	Southern Rengma Naga	nre					
nrg	Narango	nrg					
nri	Chokri Naga	nri					
nrl	Ngarluma	nrl					
nrm	Narom	nrm					Norman;Normannisch
nrn	Norn	nrn					
nrp	North Picene	nrp					
nrr	Norra	nrr					
nrt	Northern Kalapuya	nrt					
nru	Narua	nru					
nrx	Ngurmbur	nrx					
nrz	Lala	nrz					
nsa	Sangtam Naga	nsa					
nsc	Nshi	nsc					
nsd	Southern Nisu	nsd					
nse	Nsenga	nse					
nsf	Northwestern Nisu	nsf					
nsg	Ngasa	nsg					
nsh	Ngoshie	nsh					
nsi	Nigerian Sign Language	nsi					
nsk	Naskapi	nsk					
nsl	Norwegian Sign Language	nsl					
nsm	Sumi Naga	nsm					
nsn	Nehan	nsn					
nso	Pedi	nso	nso	nso			Nord-Sotho;Sepedi;sotho du Nord;pedi;Northern Sotho;sepedi
nsp	Nepalese Sign Language	nsp					
nsq	Northern Sierra Miwok	nsq					
nsr	Maritime Sign Language	nsr					
nss	Nali	nss					
nst	Tase Naga	nst					
nsu	Sierra Negra Nahuatl	nsu					
nsv	Southwestern Nisu	nsv					
nsw	Navut	nsw					
nsx	Nsongo	nsx					
nsy	Nasal	nsy					
nsz	Nisenan	nsz					
nte	Nathembo	nte					
nti	Natioro	nti					
ntj	Ngaanyatjarra	ntj					
ntk	Ikoma-Nata-Isenye	ntk					
ntm	Nateni	ntm					
nto	Ntomba	nto					
ntp	Northern Tepehuan	ntp					
ntr	Delo	ntr					
nts	Natagaimas	nts					
ntu	Natügu	ntu					
ntw	Nottoway	ntw					
ntx	Tangkhul Naga (Myanmar)	ntx					
nty	Mantsi	nty					
ntz	Natanzi	ntz					
nua	Yuaga	nua					
nuc	Nukuini	nuc					
nud	Ngala	nud					
nue	Ngundu	nue					
nuf	Nusu	nuf					
nug	Nungali	nug					
nuh	Ndunda	nuh					
nui	Ngumbi	nui					
nuj	Nyole	nuj					
nuk	Nuu-chah-nulth	nuk					
nul	Nusa Laut	nul					
num	Niuafo'ou	num					
nun	Anong	nun					
nuo	Nguôn	nuo					
nup	Nupe-Nupe-Tako	nup					
nuq	Nukumanu	nuq					
nur	Nukuria	nur					
nus	Nuer	nus					
nut	Nung (Viet Nam)	nut					
nuu	Ngbundu	nuu					
nuv	Northern Nuni	nuv					
nuw	Nguluwan	nuw					
nux	Mehek	nux					
nuy	Nunggubuyu	nuy					
nuz	Tlamacazapa Nahuatl	nuz					
nvh	Nasarian	nvh					
nvm	Namiae	nvm					
nvo	Nyokon	nvo					
nwa	Nawathinehena	nwa					
nwb	Nyabwa	nwb					
nwc	Classical Newari	nwc	nwc	nwc			Old Newari;newari classique;Classical Nepal Bhasa
nwe	Ngwe	nwe					
nwg	Ngayawung	nwg					
nwi	Southwest Tanna	nwi					
nwm	Nyamusa-Molo	nwm					
nwo	Nauo	nwo					
nwr	Nawaru	nwr					
nwx	Middle Newar	nwx					
nwy	Nottoway-Meherrin	nwy					
nxa	Nauete	nxa					
nxd	Ngando (Democratic Republic of Congo)	nxd					
nxe	Nage	nxe					
nxg	Ngad'a	nxg					
nxi	Nindi	nxi					
nxk	Koki Naga	nxk					
nxl	South Nuaulu	nxl					
nxm	Numidian	nxm					
nxn	Ngawun	nxn					
nxq	Naxi	nxq					
nxr	Ninggerum	nxr					
nxu	Narau	nxu					
nxx	Nafri	nxx					
nya	Nyanja	nya	nya	nya	ny	ny	chewa;chichewa;Chichewa;nyanja;Chewa
nyb	Nyangbo	nyb					
nyc	Nyanga-li	nyc					
nyd	Nyore	nyd					
nye	Nyengo	nye					
nyf	Giryama	nyf					
nyg	Nyindu	nyg					
nyh	Nyigina	nyh					
nyi	Ama (Sudan)	nyi					
nyj	Nyanga	nyj					
nyk	Nyaneka	nyk					
nyl	Nyeu	nyl					
nym	Nyamwezi	nym	nym	nym			nyamwezi
nyn	Nyankole	nyn	nyn	nyn			nyankolé
nyo	Nyoro	nyo	nyo	nyo			nyoro
nyp	Nyang'i	nyp					
nyq	Nayini	nyq					
nyr	Nyiha (Malawi)	nyr					
nys	Nyunga	nys					
nyt	Nyawaygi	nyt					
nyu	Nyungwe	nyu					
nyv	Nyulnyul	nyv					
nyw	Nyaw	nyw					
nyx	Nganyaywana	nyx					
nyy	Nyakyusa-Ngonde	nyy					
nza	Tigon Mbembe	nza					
nzb	Njebi	nzb					
nzi	Nzima	nzi	nzi	nzi			nzema
nzk	Nzakara	nzk					
nzm	Zeme Naga	nzm					
nzs	New Zealand Sign Language	nzs					
nzu	Teke-Nzikou	nzu					
nzy	Nzakambay	nzy					
nzz	Nanga Dama Dogon	nzz					
oaa	Orok	oaa					
oac	Oroch	oac					
oar	Old Aramaic (up to 700 BCE)	oar					
oav	Old Avar	oav					
obi	Obispeño	obi					
obk	Southern Bontok	obk					
obl	Oblo	obl					
obm	Moabite	obm					
obo	Obo Manobo	obo					
obr	Old Burmese	obr					
obt	Old Breton	obt					
obu	Obulom	obu					
oca	Ocaina	oca					
och	Old Chinese	och					
oci	Occitan	oci	oci	oci	oc	oc	Occitan (post 1500);occitan (après 1500);Okzitanisch
oco	Old Cornish	oco					
ocu	Atzingo Matlatzinca	ocu					
oda	Odut	oda					
odk	Od	odk					
odt	Old Dutch	odt					
odu	Odual	odu					
ofo	Ofo	ofo					
ofs	Old Frisian	ofs					
ofu	Efutop	ofu					
ogb	Ogbia	ogb					
ogc	Ogbah	ogc					
oge	Old Georgian	oge					
ogg	Ogbogolo	ogg					
ogo	Khana	ogo					
ogu	Ogbronuagum	ogu					
oht	Old Hittite	oht					
ohu	Old Hungarian	ohu					
oia	Oirata	oia					
oin	Inebu One	oin					
ojb	Northwestern Ojibwa	ojb					
ojc	Central Ojibwa	ojc					
ojg	Eastern Ojibwa	ojg					
oji	Ojibwa	oji	oji	oji	oj	oj	ojibwa;Ojibwe
ojp	Old Japanese	ojp					
ojs	Severn Ojibwa	ojs					
ojv	Ontong Java	ojv					
ojw	Western Ojibwa	ojw					
oka	Okanagan	oka					
okb	Okobo	okb					
okd	Okodia	okd					
oke	Okpe (Southwestern Edo)	oke					
okg	Koko Babangk	okg					
okh	Koresh-e Rostam	okh					
oki	Okiek	oki					
okj	Oko-Juwoi	okj					
okk	Kwamtim One	okk					
okl	Old Kentish Sign Language	okl					
okm	Middle Korean	okm					Middle Korean (10th-16th cent.)
okn	Oki-No-Erabu	okn					
oko	Old Korean (3rd-9th cent.)	oko					
okr	Kirike	okr					
oks	Oko-Eni-Osayen	oks					
oku	Oku	oku					
okv	Orokaiva	okv					
okx	Okpe (Northwestern Edo)	okx					
ola	Walungge	ola					
old	Mochi	old					
ole	Olekha	ole					
olm	Oloma	olm					
olo	Livvi	olo					
olr	Olrat	olr					
oma	Omaha-Ponca	oma					
omb	East Ambae	omb					
omc	Mochica	omc					
ome	Omejes	ome					
omg	Omagua	omg					
omi	Omi	omi					
omk	Omok	omk					
oml	Ombo	oml					
omn	Minoan	omn					
omo	Utarmbung	omo					
omp	Old Manipuri	omp					
omr	Old Marathi	omr					
omt	Omotik	omt					
omu	Omurano	omu					
omw	South Tairora	omw					
omx	Old Mon	omx					
ona	Ona	ona					
onb	Lingao	onb					
one	Oneida	one					
ong	Olo	ong					
oni	Onin	oni					
onj	Onjob	onj					
onk	Kabore One	onk					
onn	Onobasulu	onn					
ono	Onondaga	ono					
onp	Sartang	onp					
onr	Northern One	onr					
ons	Ono	ons					
ont	Ontenu	ont					
onu	Unua	onu					
onw	Old Nubian	onw					
onx	Onin Based Pidgin	onx					
ood	Tohono O'odham	ood					O'odham
oog	Ong	oog					
oon	Önge	oon					
oor	Oorlams	oor					
oos	Old Ossetic	oos					
opa	Okpamheri	opa					
opk	Kopkaka	opk					
opm	Oksapmin	opm					
opo	Opao	opo					
opt	Opata	opt					
opy	Ofayé	opy					
ora	Oroha	ora					
orc	Orma	orc					
ore	Orejón	ore					
org	Oring	org					
orh	Oroqen	orh					
ori	Oriya	ori	ori	ori	or	or	Oriya (macrolanguage);Orija;oriya
orm	Oromo	orm	orm	orm	om	om	galla
orn	Orang Kanaq	orn					
oro	Orokolo	oro					
orr	Oruma	orr					
ors	Orang Seletar	ors					
ort	Adivasi Oriya	ort					
oru	Ormuri	oru					
orv	Old Russian	orv					
orw	Oro Win	orw					
orx	Oro	orx					
ory	Oriya (individual language)	ory					
orz	Ormu	orz					
osa	Osage	osa	osa	osa			osage
osc	Oscan	osc					
osi	Osing	osi					
oso	Ososo	oso					
osp	Old Spanish	osp					
oss	Ossetian	oss	oss	oss	os	os	ossète;Ossetic;Ossetisch
ost	Osatu	ost					
osu	Southern One	osu					
osx	Old Saxon	osx					
ota	Ottoman Turkish	ota	ota	ota			Turkish, Ottoman (1500-1928);turc ottoman (1500-1928);Ottoman Turkish (1500-1928)
otb	Old Tibetan	otb					
otd	Ot Danum	otd					
ote	Mezquital Otomi	ote					
oti	Oti	oti					
otk	Old Turkish	otk					
otl	Tilapa Otomi	otl					
otm	Eastern Highland Otomi	otm					
otn	Tenango Otomi	otn					
otq	Querétaro Otomi	otq					
otr	Otoro	otr					
ots	Estado de México Otomi	ots					
ott	Temoaya Otomi	ott					
otu	Otuke	otu					
otw	Ottawa	otw					
otx	Texcatepec Otomi	otx					
oty	Old Tamil	oty					
otz	Ixtenco Otomi	otz					
oua	Tagargrent	oua					
oub	Glio-Oubi	oub					
oue	Oune	oue					
oui	Old Uighur	oui					
oum	Ouma	oum					
oun	!O!ung	oun					
owi	Owiniga	owi					
owl	Old Welsh	owl					
oyb	Oy	oyb					
oyd	Oyda	oyd					
oym	Wayampi	oym					
oyy	Oya'oya	oyy					
ozm	Koonzime	ozm					
pab	Parecís	pab					
pac	Pacoh	pac					
pad	Paumarí	pad					
pae	Pagibete	pae					
paf	Paranawát	paf					
pag	Pangasinan	pag	pag	pag			pangasinan
pah	Tenharim	pah					
pai	Pe	pai					
pak	Parakanã	pak					
pal	Pahlavi	pal	pal	pal			pahlavi
pam	Pampanga	pam	pam	pam			Pampangan;Pampango;Kapampangan;pampangan
pan	Panjabi	pan	pan	pan	pa	pa	pendjabi;Punjabi;Pandschabisch/Pundjabisch
pao	Northern Paiute	pao					
pap	Papiamento	pap	pap	pap			papiamento;Papiamentu
paq	Parya	paq					
par	Panamint	par					
pas	Papasena	pas					
pat	Papitalai	pat					
pau	Palauan	pau	pau	pau			palau
pav	Pakaásnovos	pav					
paw	Pawnee	paw					
pax	Pankararé	pax					
pay	Pech	pay					
paz	Pankararú	paz					
pbb	Páez	pbb					
pbc	Patamona	pbc					
pbe	Mezontla Popoloca	pbe					
pbf	Coyotepec Popoloca	pbf					
pbg	Paraujano	pbg					
pbh	E'ñapa Woromaipu	pbh					
pbi	Parkwa	pbi					
pbl	Mak (Nigeria)	pbl					
pbn	Kpasam	pbn					
pbo	Papel	pbo					
pbp	Badyara	pbp					
pbr	Pangwa	pbr					
pbs	Central Pame	pbs					
pbt	Southern Pashto	pbt					
pbu	Northern Pashto	pbu					
pbv	Pnar	pbv					
pby	Pyu	pby					
pca	Santa Inés Ahuatempan Popoloca	pca					
pcb	Pear	pcb					
pcc	Bouyei	pcc					
pcd	Picard	pcd					
pce	Ruching Palaung	pce					
pcf	Paliyan	pcf					
pcg	Paniya	pcg					
pch	Pardhan	pch					
pci	Duruwa	pci					
pcj	Parenga	pcj					
pck	Paite Chin	pck					
pcl	Pardhi	pcl					
pcm	Nigerian Pidgin	pcm					
pcn	Piti	pcn					
pcp	Pacahuara	pcp					
pcr	Panang	pcr					
pcw	Pyapun	pcw					
pda	Anam	pda					
pdc	Pennsylvania German	pdc					Deitsch;Pennsylvania Dutch;Pennsylvaniadeutsch
pdi	Pa Di	pdi					
pdn	Podena	pdn					
pdo	Padoe	pdo					
pdt	Plautdietsch	pdt					
pdu	Kayan	pdu					
pea	Peranakan Indonesian	pea					
peb	Eastern Pomo	peb					
ped	Mala (Papua New Guinea)	ped					
pee	Taje	pee					
pef	Northeastern Pomo	pef					
peg	Pengo	peg					
peh	Bonan	peh					
pei	Chichimeca-Jonaz	pei					
pej	Northern Pomo	pej					
pek	Penchal	pek					
pel	Pekal	pel					
pem	Phende	pem					
peo	Old Persian	peo	peo	peo			Old Persian (ca. 600-400 B.C.);Persian, Old (ca.600-400 B.C.);perse, vieux (ca. 600-400 av. J.-C.)
pep	Kunja	pep					
peq	Southern Pomo	peq					
pes	Iranian Persian	pes					
pev	Pémono	pev					
pex	Petats	pex					
pey	Petjo	pey					
pez	Eastern Penan	pez					
pfa	Pááfang	pfa					
pfe	Peere	pfe					
pfl	Pfaelzisch	pfl					
pga	Sudanese Creole Arabic	pga					
pgg	Pangwali	pgg					
pgi	Pagi	pgi					
pgk	Rerep	pgk					
pgl	Primitive Irish	pgl					
pgn	Paelignian	pgn					
pgs	Pangseng	pgs					
pgu	Pagu	pgu					
pha	Pa-Hng	pha					
phd	Phudagi	phd					
phg	Phuong	phg					
phh	Phukha	phh					
phk	Phake	phk					
phl	Phalura	phl					
phm	Phimbi	phm					
phn	Phoenician	phn	phn	phn			phénicien
pho	Phunoi	pho					
phq	Phana'	phq					
phr	Pahari-Potwari	phr					
pht	Phu Thai	pht					
phu	Phuan	phu					
phv	Pahlavani	phv					
phw	Phangduwali	phw					
pia	Pima Bajo	pia					
pib	Yine	pib					
pic	Pinji	pic					
pid	Piaroa	pid					
pie	Piro	pie					
pif	Pingelapese	pif					
pig	Pisabo	pig					
pih	Pitcairn-Norfolk	pih					
pii	Pini	pii					
pij	Pijao	pij					
pil	Yom	pil					
pim	Powhatan	pim					
pin	Piame	pin					
pio	Piapoco	pio					
pip	Pero	pip					
pir	Piratapuyo	pir					
pis	Pijin	pis					Salomonen-Pidgin;Pijin/Neu-Salomonisch
pit	Pitta Pitta	pit					Pitta-Pitta
piu	Pintupi-Luritja	piu					
piv	Pileni	piv					
piw	Pimbwe	piw					
pix	Piu	pix					
piy	Piya-Kwonci	piy					
piz	Pije	piz					
pjt	Pitjantjatjara	pjt					
pka	Ardhamāgadhī Prākrit	pka					
pkb	Pokomo	pkb					
pkc	Paekche	pkc					
pkg	Pak-Tong	pkg					
pkh	Pankhu	pkh					
pkn	Pakanha	pkn					
pko	Pökoot	pko					
pkp	Pukapuka	pkp					
pkr	Attapady Kurumba	pkr					
pks	Pakistan Sign Language	pks					
pkt	Maleng	pkt					
pku	Paku	pku					
pla	Miani	pla					
plb	Polonombauk	plb					
plc	Central Palawano	plc					
pld	Polari	pld					
ple	Palu'e	ple					
plg	Pilagá	plg					
plh	Paulohi	plh					
pli	Pali	pli	pli	pli	pi	pi	pali
plj	Polci	plj					
plk	Kohistani Shina	plk					
pll	Shwe Palaung	pll					
pln	Palenquero	pln					
plo	Oluta Popoluca	plo					
plp	Palpa	plp					
plq	Palaic	plq					
plr	Palaka Senoufo	plr					
pls	San Marcos Tlalcoyalco Popoloca	pls					
plt	Plateau Malagasy	plt					
plu	Palikúr	plu					
plv	Southwest Palawano	plv					
plw	Brooke's Point Palawano	plw					
ply	Bolyu	ply					
plz	Paluan	plz					
pma	Paama	pma					
pmb	Pambia	pmb					
pmc	Palumata	pmc					
pmd	Pallanganmiddang	pmd					
pme	Pwaamei	pme					
pmf	Pamona	pmf					
pmh	Māhārāṣṭri Prākrit	pmh					
pmi	Northern Pumi	pmi					
pmj	Southern Pumi	pmj					
pmk	Pamlico	pmk					
pml	Lingua Franca	pml					
pmm	Pomo	pmm					
pmn	Pam	pmn					
pmo	Pom	pmo					
pmq	Northern Pame	pmq					
pmr	Paynamar	pmr					
pms	Piemontese	pms					Piemontisch;Piedmontese
pmt	Tuamotuan	pmt					
pmu	Mirpur Panjabi	pmu					
pmw	Plains Miwok	pmw					
pmx	Poumei Naga	pmx					
pmy	Papuan Malay	pmy					
pmz	Southern Pame	pmz					
pna	Punan Bah-Biau	pna					
pnb	Western Panjabi	pnb					
pnc	Pannei	pnc					
pne	Western Penan	pne					
png	Pongu	png					
pnh	Penrhyn	pnh					
pni	Aoheng	pni					
pnk	Paunaka	pnk					
pnm	Punan Batu 1	pnm					
pnn	Pinai-Hagahai	pnn					
pno	Panobo	pno					
pnp	Pancana	pnp					
pnq	Pana (Burkina Faso)	pnq					
pnr	Panim	pnr					
pns	Ponosakan	pns					
pnt	Pontic	pnt					Pontic Greek
pnu	Jiongnai Bunu	pnu					
pnv	Pinigura	pnv					
pnw	Panytyima	pnw					Panyjima
pnx	Phong-Kniang	pnx					
pny	Pinyin	pny					
pnz	Pana (Central African Republic)	pnz					
poc	Poqomam	poc					
pod	Ponares	pod					
poe	San Juan Atzingo Popoloca	poe					
pof	Poke	pof					
pog	Potiguára	pog					
poh	Poqomchi'	poh					
poi	Highland Popoluca	poi					
pok	Pokangá	pok					
pol	Polish	pol	pol	pol	pl	pl	Polnisch;polonais
pom	Southeastern Pomo	pom					
pon	Pohnpeian	pon	pon	pon			pohnpei
poo	Central Pomo	poo					
pop	Pwapwa	pop					
poq	Texistepec Popoluca	poq					
por	Portuguese	por	por	por	pt	pt	Portugiesisch;portugais
pos	Sayula Popoluca	pos					
pot	Potawatomi	pot					
pov	Upper Guinea Crioulo	pov					
pow	San Felipe Otlaltepec Popoloca	pow					
pox	Polabian	pox					
poy	Pogolo	poy					
ppa	Pao	ppa					
ppe	Papi	ppe					
ppi	Paipai	ppi					
ppk	Uma	ppk					
ppl	Pipil	ppl					
ppm	Papuma	ppm					
ppn	Papapana	ppn					
ppo	Folopa	ppo					
ppp	Pelende	ppp					
ppq	Pei	ppq					
ppr	Piru	ppr					
pps	San Luís Temalacayuca Popoloca	pps					
ppt	Pare	ppt					
ppu	Papora	ppu					
pqa	Pa'a	pqa					
pqm	Malecite-Passamaquoddy	pqm					
prb	Lua'	prb					
prc	Parachi	prc					
prd	Parsi-Dari	prd					
pre	Principense	pre					
prf	Paranan	prf					
prg	Prussian	prg					Old Prussian;Prußisch
prh	Porohanon	prh					
pri	Paicî	pri					
prk	Parauk	prk					
prl	Peruvian Sign Language	prl					
prm	Kibiri	prm					
prn	Prasuni	prn					
pro	Old Provençal	pro	pro	pro			provençal ancien (jusqu'à 1500);Old Provencal;occitan ancien (jusqu'à 1500);Occitan, Old (to 1500);Old Provençal (to 1500);Provençal, Old (to 1500)
prp	Parsi	prp					
prq	Ashéninka Perené	prq					
prr	Puri	prr					
prs	Dari	prs					
prt	Phai	prt					
pru	Puragi	pru					
prw	Parawen	prw					
prx	Purik	prx					
pry	Pray 3	pry					
prz	Providencia Sign Language	prz					
psa	Asue Awyu	psa					
psc	Persian Sign Language	psc					
psd	Plains Indian Sign Language	psd					
pse	Central Malay	pse					
psg	Penang Sign Language	psg					
psh	Southwest Pashayi	psh					
psi	Southeast Pashayi	psi					
psl	Puerto Rican Sign Language	psl					
psm	Pauserna	psm					
psn	Panasuan	psn					
pso	Polish Sign Language	pso					
psp	Philippine Sign Language	psp					
psq	Pasi	psq					
psr	Portuguese Sign Language	psr					
pss	Kaulong	pss					
pst	Central Pashto	pst					
psu	Sauraseni Prākrit	psu					
psw	Port Sandwich	psw					
psy	Piscataway	psy					
pta	Pai Tavytera	pta					
pth	Pataxó Hã-Ha-Hãe	pth					
pti	Pintiini	pti					
ptn	Patani	ptn					
pto	Zo'é	pto					
ptp	Patep	ptp					
ptr	Piamatsina	ptr					
ptt	Enrekang	ptt					
ptu	Bambam	ptu					
ptv	Port Vato	ptv					
ptw	Pentlatch	ptw					
pty	Pathiya	pty					
pua	Western Highland Purepecha	pua					
pub	Purum	pub					
puc	Punan Merap	puc					
pud	Punan Aput	pud					
pue	Puelche	pue					
puf	Punan Merah	puf					
pug	Phuie	pug					
pui	Puinave	pui					
puj	Punan Tubu	puj					
puk	Pu Ko	puk					
pum	Puma	pum					
puo	Puoc	puo					
pup	Pulabu	pup					
puq	Puquina	puq					
pur	Puruborá	pur					
pus	Pushto	pus	pus	pus	ps	ps	Paschtu/Afghanisch;Afghanisch;pachto;Pashto;Paschto;Paschtunisch
put	Putoh	put					
puu	Punu	puu					
puw	Puluwatese	puw					
pux	Puare	pux					
puy	Purisimeño	puy					
puz	Purum Naga	puz					
pwa	Pawaia	pwa					
pwb	Panawa	pwb					
pwg	Gapapaiwa	pwg					
pwm	Molbog	pwm					
pwn	Paiwan	pwn					
pwo	Pwo Western Karen	pwo					
pwr	Powari	pwr					
pww	Pwo Northern Karen	pww					
pxm	Quetzaltepec Mixe	pxm					
pye	Pye Krumen	pye					
pym	Fyam	pym					
pyn	Poyanáwa	pyn					
pys	Paraguayan Sign Language	pys					
pyu	Puyuma	pyu					
pyx	Pyu (Myanmar)	pyx					
pyy	Pyen	pyy					
pzn	Para Naga	pzn					
qua	Quapaw	qua					
qub	Huallaga Huánuco Quechua	qub					
quc	K'iche'	quc					
qud	Calderón Highland Quichua	qud					
que	Quechua	que	que	que	qu	qu	Ketschua;quechua
quf	Lambayeque Quechua	quf					
qug	Chimborazo Highland Quichua	qug					
quh	South Bolivian Quechua	quh					
qui	Quileute	qui					
quk	Chachapoyas Quechua	quk					
qul	North Bolivian Quechua	qul					
qum	Sipacapense	qum					
qun	Quinault	qun					
qup	Southern Pastaza Quechua	qup					
quq	Quinqui	quq					
qur	Yanahuanca Pasco Quechua	qur					
qus	Santiago del Estero Quichua	qus					
quv	Sacapulteco	quv					
quw	Tena Lowland Quichua	quw					
qux	Yauyos Quechua	qux					
quy	Ayacucho Quechua	quy					
quz	Cusco Quechua	quz					
qva	Ambo-Pasco Quechua	qva					
qvc	Cajamarca Quechua	qvc					
qve	Eastern Apurímac Quechua	qve					
qvh	Huamalíes-Dos de Mayo Huánuco Quechua	qvh					
qvi	Imbabura Highland Quichua	qvi					
qvj	Loja Highland Quichua	qvj					
qvl	Cajatambo North Lima Quechua	qvl					
qvm	Margos-Yarowilca-Lauricocha Quechua	qvm					
qvn	North Junín Quechua	qvn					
qvo	Napo Lowland Quechua	qvo					
qvp	Pacaraos Quechua	qvp					
qvs	San Martín Quechua	qvs					
qvw	Huaylla Wanca Quechua	qvw					
qvy	Queyu	qvy					
qvz	Northern Pastaza Quichua	qvz					
qwa	Corongo Ancash Quechua	qwa					
qwc	Classical Quechua	qwc					
qwh	Huaylas Ancash Quechua	qwh					
qwm	Kuman (Russia)	qwm					
qws	Sihuas Ancash Quechua	qws					
qwt	Kwalhioqua-Tlatskanai	qwt					
qxa	Chiquián Ancash Quechua	qxa					
qxc	Chincha Quechua	qxc					
qxh	Panao Huánuco Quechua	qxh					
qxl	Salasaca Highland Quichua	qxl					
qxn	Northern Conchucos Ancash Quechua	qxn					
qxo	Southern Conchucos Ancash Quechua	qxo					
qxp	Puno Quechua	qxp					
qxq	Qashqa'i	qxq					
qxr	Cañar Highland Quichua	qxr					
qxs	Southern Qiang	qxs					
qxt	Santa Ana de Tusi Pasco Quechua	qxt					
qxu	Arequipa-La Unión Quechua	qxu					
qxw	Jauja Wanca Quechua	qxw					
qya	Quenya	qya					
qyp	Quiripi	qyp					
raa	Dungmali	raa					
rab	Camling	rab					
rac	Rasawa	rac					
rad	Rade	rad					
raf	Western Meohang	raf					
rag	Logooli	rag					
rah	Rabha	rah					
rai	Ramoaaina	rai					
raj	Rajasthani	raj	raj	raj			rajasthani
rak	Tulu-Bohuai	rak					
ral	Ralte	ral					
ram	Canela	ram					
ran	Riantana	ran					
rao	Rao	rao					
rap	Rapanui	rap	rap	rap			Rapa Nui;rapanui
raq	Saam	raq					
rar	Rarotongan	rar	rar	rar			rarotonga;maori des îles Cook;Cook Islands Maori
ras	Tegali	ras					
rat	Razajerdi	rat					
rau	Raute	rau					
rav	Sampang	rav					
raw	Rawang	raw					
rax	Rang	rax					
ray	Rapa	ray					
raz	Rahambuu	raz					
rbb	Rumai Palaung	rbb					
rbk	Northern Bontok	rbk					
rbl	Miraya Bikol	rbl					
rbp	Barababaraba	rbp					
rcf	Réunion Creole French	rcf					
rdb	Rudbari	rdb					
rea	Rerau	rea					
reb	Rembong	reb					
ree	Rejang Kayan	ree					
reg	Kara (Tanzania)	reg					
rei	Reli	rei					
rej	Rejang	rej					
rel	Rendille	rel					
rem	Remo	rem					
ren	Rengao	ren					
rer	Rer Bare	rer					
res	Reshe	res					
ret	Retta	ret					
rey	Reyesano	rey					
rga	Roria	rga					
rge	Romano-Greek	rge					
rgk	Rangkas	rgk					
rgn	Romagnol	rgn					
rgr	Resígaro	rgr					
rgs	Southern Roglai	rgs					
rgu	Ringgou	rgu					
rhg	Rohingya	rhg				cit	
rhp	Yahang	rhp					
ria	Riang (India)	ria					
rie	Rien	rie					
rif	Tarifit	rif					
ril	Riang (Myanmar)	ril					
rim	Nyaturu	rim					
rin	Nungu	rin					
rir	Ribun	rir					
rit	Ritarungo	rit					
riu	Riung	riu					
rjg	Rajong	rjg					
rji	Raji	rji					
rjs	Rajbanshi	rjs					
rka	Kraol	rka					
rkb	Rikbaktsa	rkb					
rkh	Rakahanga-Manihiki	rkh					
rki	Rakhine	rki					
rkm	Marka	rkm					
rkt	Rangpuri	rkt					
rma	Rama	rma					
rmb	Rembarunga	rmb					
rmc	Carpathian Romani	rmc					
rmd	Traveller Danish	rmd					
rme	Angloromani	rme					
rmf	Kalo Finnish Romani	rmf					
rmg	Traveller Norwegian	rmg					
rmh	Murkim	rmh					
rmi	Lomavren	rmi					
rmk	Romkun	rmk					
rml	Baltic Romani	rml					
rmm	Roma	rmm					
rmn	Balkan Romani	rmn					
rmo	Sinte Romani	rmo					
rmp	Rempi	rmp					
rmq	Caló	rmq					Calo;rmr
rms	Romanian Sign Language	rms					
rmt	Domari	rmt					
rmu	Tavringer Romani	rmu					
rmv	Romanova	rmv					
rmw	Welsh Romani	rmw					
rmx	Romam	rmx					
rmy	Vlax Romani	rmy					
rmz	Marma	rmz					
rna	Runa	rna					
rnd	Ruund	rnd					
rng	Ronga	rng					
rnl	Ranglong	rnl					
rnn	Roon	rnn					
rnp	Rongpo	rnp					
rnr	Nari Nari	rnr					
rnw	Rungwa	rnw					
rob	Tae'	rob					
roc	Cacgia Roglai	roc					
rod	Rogo	rod					
roe	Ronji	roe					
rof	Rombo	rof					
rog	Northern Roglai	rog					
roh	Romansh	roh	roh	roh	rm	rm	Rätoromanisch;Romansch;romanche
rol	Romblomanon	rol					
rom	Romany	rom	rom	rom			tsigane;Romani;Romanes
ron	Romanian	ron	rum	ron	ro	ro;mo;rum	moldave;roumain;Moldovan;Rumänisch;Moldauisch/Moldawisch;Moldavian
roo	Rotokas	roo					
rop	Kriol	rop					
ror	Rongga	ror					
rou	Runga	rou					
row	Dela-Oenale	row					
rpn	Repanbitip	rpn					
rpt	Rapting	rpt					
rri	Ririo	rri					
rro	Waima	rro					
rrt	Arritinngithigh	rrt					
rsb	Romano-Serbian	rsb					
rsi	Rennellese Sign Language	rsi					
rsl	Russian Sign Language	rsl					
rtc	Rungtu Chin	rtc					
rth	Ratahan	rth					
rtm	Rotuman	rtm					
rtw	Rathawi	rtw					
rub	Gungu	rub					
ruc	Ruuli	ruc					
rue	Rusyn	rue					
ruf	Luguru	ruf					
rug	Roviana	rug					
ruh	Ruga	ruh					
rui	Rufiji	rui					
ruk	Che	ruk					
run	Rundi	run	run	run	rn	rn	Kirundi;Kirundi (Rundisch);rundi
ruo	Istro Romanian	ruo					Istro-Romanian
rup	Macedo-Romanian	rup	rup	rup			Aromanian;Arumanian;macédo-roumain;Aromunisch;aroumain
ruq	Megleno Romanian	ruq					Megleno-Romanian
rus	Russian	rus	rus	rus	ru	ru	russe;Russisch
rut	Rutul	rut					
ruu	Lanas Lobu	ruu					
ruy	Mala (Nigeria)	ruy					
ruz	Ruma	ruz					
rwa	Rawo	rwa					
rwk	Rwa	rwk					
rwm	Amba (Uganda)	rwm					
rwo	Rawa	rwo					
rwr	Marwari (India)	rwr					
ryn	Northern Amami-Oshima	ryn					
rys	Yaeyama	rys					
ryu	Central Okinawan	ryu					
saa	Saba	saa					
sab	Buglere	sab					
sac	Meskwaki	sac					
sad	Sandawe	sad	sad	sad			sandawe
sae	Sabanê	sae					
saf	Safaliba	saf					
sag	Sango	sag	sag	sag	sg	sg	sango
sah	Yakut	sah	sah	sah			iakoute;Jakutisch
saj	Sahu	saj					
sak	Sake	sak					
sam	Samaritan Aramaic	sam	sam	sam			samaritain
san	Sanskrit	san	san	san	sa	sa	sanskrit
sao	Sause	sao					
sap	Sanapaná	sap					
saq	Samburu	saq					
sar	Saraveca	sar					
sas	Sasak	sas	sas	sas			sasak
sat	Santali	sat	sat	sat			santal
sau	Saleman	sau					
sav	Saafi-Saafi	sav					
saw	Sawi	saw					
sax	Sa	sax					
say	Saya	say					
saz	Saurashtra	saz					
sba	Ngambay	sba					
sbb	Simbo	sbb					
sbc	Kele (Papua New Guinea)	sbc					
sbd	Southern Samo	sbd					
sbe	Saliba	sbe					
sbf	Shabo	sbf					
sbg	Seget	sbg					
sbh	Sori-Harengan	sbh					
sbi	Seti	sbi					
sbj	Surbakhal	sbj					
sbk	Safwa	sbk					
sbl	Botolan Sambal	sbl					
sbm	Sagala	sbm					
sbn	Sindhi Bhil	sbn					
sbo	Sabüm	sbo					
sbp	Sangu (Tanzania)	sbp					
sbq	Sileibi	sbq					
sbr	Sembakung Murut	sbr					
sbs	Subiya	sbs					
sbt	Kimki	sbt					
sbu	Stod Bhoti	sbu					
sbv	Sabine	sbv					
sbw	Simba	sbw					
sbx	Seberuang	sbx					
sby	Soli	sby					
sbz	Sara Kaba	sbz					
scb	Chut	scb					
sce	Dongxiang	sce					
scf	San Miguel Creole French	scf					
scg	Sanggau	scg					
sch	Sakachep	sch					
sci	Sri Lankan Creole Malay	sci					
sck	Sadri	sck					
scl	Shina	scl					
scn	Sicilian	scn	scn	scn			sicilien;Sizilianisch
sco	Scots	sco	sco	sco			écossais;Schottisch
scp	Helambu Sherpa	scp					
scq	Sa'och	scq					
scs	North Slavey	scs					
scu	Shumcho	scu					
scv	Sheni	scv					
scw	Sha	scw					
scx	Sicel	scx					
sda	Toraja-Sa'dan	sda					
sdb	Shabak	sdb					
sdc	Sassarese Sardinian	sdc					
sde	Surubu	sde					
sdf	Sarli	sdf					
sdg	Savi	sdg					
sdh	Southern Kurdish	sdh					
sdj	Suundi	sdj					
sdk	Sos Kundi	sdk					
sdl	Saudi Arabian Sign Language	sdl					
sdm	Semandang	sdm					
sdn	Gallurese Sardinian	sdn					
sdo	Bukar-Sadung Bidayuh	sdo					
sdp	Sherdukpen	sdp					
sdr	Oraon Sadri	sdr					
sds	Sened	sds					
sdt	Shuadit	sdt					
sdu	Sarudu	sdu					
sdx	Sibu Melanau	sdx					
sdz	Sallands	sdz					
sea	Semai	sea					
seb	Shempire Senoufo	seb					
sec	Sechelt	sec					
sed	Sedang	sed					
see	Seneca	see					
sef	Cebaara Senoufo	sef					
seg	Segeju	seg					
seh	Sena	seh					
sei	Seri	sei					
sej	Sene	sej					
sek	Sekani	sek					
sel	Selkup	sel	sel	sel			selkoupe
sen	Nanerigé Sénoufo	sen					
seo	Suarmin	seo					
sep	Sìcìté Sénoufo	sep					
seq	Senara Sénoufo	seq					
ser	Serrano	ser					
ses	Koyraboro Senni Songhai	ses					
set	Sentani	set					
seu	Serui-Laut	seu					
sev	Nyarafolo Senoufo	sev					
sew	Sewa Bay	sew					
sey	Secoya	sey					
sez	Senthang Chin	sez					
sfb	Langue des signes de Belgique Francophone	sfb					
sfe	Eastern Subanen	sfe					
sfm	Small Flowery Miao	sfm					
sfs	South African Sign Language	sfs					
sfw	Sehwi	sfw					
sga	Old Irish	sga	sga	sga			Old Irish (to 900);Irish, Old (to 900);irlandais ancien (jusqu'à 900);Altirisch
sgb	Mag-antsi Ayta	sgb					
sgc	Kipsigis	sgc					
sgd	Surigaonon	sgd					
sge	Segai	sge					
sgg	Swiss-German Sign Language	sgg					
sgh	Shughni	sgh					
sgi	Suga	sgi					
sgj	Surgujia	sgj					
sgk	Sangkong	sgk					
sgm	Singa	sgm					
sgo	Songa	sgo					
sgp	Singpho	sgp					
sgr	Sangisari	sgr					
sgs	Samogitian	sgs					
sgt	Brokpake	sgt					
sgu	Salas	sgu					
sgw	Sebat Bet Gurage	sgw					Gurage
sgx	Sierra Leone Sign Language	sgx					
sgy	Sanglechi	sgy					
sgz	Sursurunga	sgz					
sha	Shall-Zwall	sha					
shb	Ninam	shb					
shc	Sonde	shc					
shd	Kundal Shahi	shd					
she	Sheko	she					
shg	Shua	shg					
shh	Shoshoni	shh					
shi	Tachelhit	shi					
shj	Shatt	shj					
shk	Shilluk	shk					
shl	Shendu	shl					
shm	Shahrudi	shm					
shn	Shan	shn	shn	shn			chan
sho	Shanga	sho					
shp	Shipibo-Conibo	shp					
shq	Sala	shq					
shr	Shi	shr					
shs	Shuswap	shs					
sht	Shasta	sht					
shu	Chadian Arabic	shu					
shv	Shehri	shv					
shw	Shwai	shw					
shx	She	shx					
shy	Tachawit	shy					
shz	Syenara Senoufo	shz					
sia	Akkala Sami	sia					
sib	Sebop	sib					
sid	Sidamo	sid	sid	sid			sidamo
sie	Simaa	sie					
sif	Siamou	sif					
sig	Paasaal	sig					
sih	Zire	sih					
sii	Shom Peng	sii					
sij	Numbami	sij					
sik	Sikiana	sik					
sil	Tumulung Sisaala	sil					
sim	Mende (Papua New Guinea)	sim					
sin	Sinhala	sin	sin	sin	si	si	Singhalesisch;singhalais;Sinhalese
sip	Sikkimese	sip					
siq	Sonia	siq					
sir	Siri	sir					
sis	Siuslaw	sis					
siu	Sinagen	siu					
siv	Sumariup	siv					
siw	Siwai	siw					
six	Sumau	six					
siy	Sivandi	siy					
siz	Siwi	siz					
sja	Epena	sja					
sjb	Sajau Basap	sjb					
sjd	Kildin Sami	sjd					
sje	Pite Sami	sje					
sjg	Assangori	sjg					
sjk	Kemi Sami	sjk					
sjl	Sajalong	sjl					
sjm	Mapun	sjm					
sjn	Sindarin	sjn					
sjo	Xibe	sjo					
sjp	Surjapuri	sjp					
sjr	Siar-Lak	sjr					
sjs	Senhaja De Srair	sjs					
sjt	Ter Sami	sjt					
sju	Ume Sami	sju					
sjw	Shawnee	sjw					
ska	Skagit	ska					
skb	Saek	skb					
skc	Ma Manda	skc					
skd	Southern Sierra Miwok	skd					
ske	Seke (Vanuatu)	ske					
skf	Sakirabiá	skf					
skg	Sakalava Malagasy	skg					
skh	Sikule	skh					
ski	Sika	ski					
skj	Seke (Nepal)	skj					
skk	Sok	skk					
skm	Kutong	skm					
skn	Kolibugan Subanon	skn					
sko	Seko Tengah	sko					
skp	Sekapan	skp					
skq	Sininkere	skq					
skr	Seraiki	skr					
sks	Maia	sks					
skt	Sakata	skt					
sku	Sakao	sku					
skv	Skou	skv					
skw	Skepi Creole Dutch	skw					
skx	Seko Padang	skx					
sky	Sikaiana	sky					
skz	Sekar	skz					
slc	Sáliba	slc					
sld	Sissala	sld					
sle	Sholaga	sle					
slf	Swiss-Italian Sign Language	slf					
slg	Selungai Murut	slg					
slh	Southern Puget Sound Salish	slh					
sli	Lower Silesian	sli					
slj	Salumá	slj					
slk	Slovak	slk	slo	slk	sk	slo;sk	slovaque;Slowakisch
sll	Salt-Yui	sll					
slm	Pangutaran Sama	slm					
sln	Salinan	sln					
slp	Lamaholot	slp					
slq	Salchuq	slq					
slr	Salar	slr					
sls	Singapore Sign Language	sls					
slt	Sila	slt					
slu	Selaru	slu					
slv	Slovenian	slv	slv	slv	sl	sl	slovène;Slowenisch;Slovene
slw	Sialum	slw					
slx	Salampasu	slx					
sly	Selayar	sly					
slz	Ma'ya	slz					
sma	Southern Sami	sma	sma	sma			sami du Sud
smb	Simbari	smb					
smc	Som	smc					
smd	Sama	smd					
sme	Northern Sami	sme	sme	sme	se	se	Nordsamisch;Sámi (Nord-);Nord-Sami;Sami (Nord-);sami du Nord;Saami (Nord-);Samisch (Nord-)
smf	Auwe	smf					
smg	Simbali	smg					
smh	Samei	smh					
smj	Lule Sami	smj	smj	smj			sami de Lule
smk	Bolinao	smk					
sml	Central Sama	sml					
smm	Musasa	smm					
smn	Inari Sami	smn	smn	smn			Inari-Saami;Saami, Inari-;sami d'Inari
smo	Samoan	smo	smo	smo	sm	sm	samoan;Samoanisch
smp	Samaritan	smp					
smq	Samo	smq					
smr	Simeulue	smr					
sms	Skolt Sami	sms	sms	sms			sami skolt
smt	Simte	smt					
smu	Somray	smu					
smv	Samvedi	smv					
smw	Sumbawa	smw					
smx	Samba	smx					
smy	Semnani	smy					
smz	Simeku	smz					
sna	Shona	sna	sna	sna	sn	sn	shona;Schona
snb	Sebuyau	snb					
snc	Sinaugoro	snc					
snd	Sindhi	snd	snd	snd	sd	sd	sindhi
sne	Bau Bidayuh	sne					
snf	Noon	snf					
sng	Sanga (Democratic Republic of Congo)	sng					
snh	Shinabo	snh					
sni	Sensi	sni					
snj	Riverain Sango	snj					
snk	Soninke	snk	snk	snk			soninké
snl	Sangil	snl					
snm	Southern Ma'di	snm					
snn	Siona	snn					
sno	Snohomish	sno					
snp	Siane	snp					
snq	Sangu (Gabon)	snq					
snr	Sihan	snr					
sns	South West Bay	sns					
snu	Senggi	snu					
snv	Sa'ban	snv					
snw	Selee	snw					
snx	Sam	snx					
sny	Saniyo-Hiyewe	sny					
snz	Sinsauru	snz					
soa	Thai Song	soa					
sob	Sobei	sob					
soc	So (Democratic Republic of Congo)	soc					
sod	Songoora	sod					
soe	Songomeno	soe					
sog	Sogdian	sog	sog	sog			sogdien
soh	Aka	soh					
soi	Sonha	soi					
soj	Soi	soj					
sok	Sokoro	sok					
sol	Solos	sol					
som	Somali	som	som	som	so	so	Somalisch;somali
soo	Songo	soo					
sop	Songe	sop					
soq	Kanasi	soq					
sor	Somrai	sor					
sos	Seeku	sos					
sot	Southern Sotho	sot	sot	sot	st	st	Sesotho;Sotho;sotho du Sud;Sotho, Southern
sou	Southern Thai	sou					
sov	Sonsorol	sov					
sow	Sowanda	sow					
sox	Swo	sox					
soy	Miyobe	soy					
soz	Temi	soz					
spa	Spanish	spa	spa	spa	es	es	castillan;espagnol;Spanisch;Castilian
spb	Sepa (Indonesia)	spb					
spc	Sapé	spc					
spd	Saep	spd					
spe	Sepa (Papua New Guinea)	spe					
spg	Sian	spg					
spi	Saponi	spi					
spk	Sengo	spk					
spl	Selepet	spl					
spm	Akukem	spm					
spo	Spokane	spo					
spp	Supyire Senoufo	spp					
spq	Loreto-Ucayali Spanish	spq					
spr	Saparua	spr					
sps	Saposa	sps					
spt	Spiti Bhoti	spt					
spu	Sapuan	spu					
spv	Sambalpuri	spv					
spx	South Picene	spx					
spy	Sabaot	spy					
sqa	Shama-Sambuga	sqa					
sqh	Shau	sqh					
sqi	Albanian	sqi	alb	sqi	sq	sq;alb	albanais;Albanisch
sqk	Albanian Sign Language	sqk					
sqm	Suma	sqm					
sqn	Susquehannock	sqn					
sqo	Sorkhei	sqo					
sqq	Sou	sqq					
sqr	Siculo Arabic	sqr					
sqs	Sri Lankan Sign Language	sqs					
sqt	Soqotri	sqt					
squ	Squamish	squ					
sra	Saruga	sra					
srb	Sora	srb					
src	Logudorese Sardinian	src					
srd	Sardinian	srd	srd	srd	sc	sc	Sardinisch;Sardisch;sarde
sre	Sara	sre					
srf	Nafi	srf					
srg	Sulod	srg					
srh	Sarikoli	srh					
sri	Siriano	sri					
srk	Serudung Murut	srk					
srl	Isirawa	srl					
srm	Saramaccan	srm					
srn	Sranan Tongo	srn	srn	srn			sranan tongo;Sranan
sro	Campidanese Sardinian	sro					
srp	Serbian	srp	srp	srp	sr	sr	Serbisch;serbe
srq	Sirionó	srq					
srr	Serer	srr	srr	srr			sérère
srs	Sarsi	srs					
srt	Sauri	srt					
sru	Suruí	sru					
srv	Southern Sorsoganon	srv					
srw	Serua	srw					
srx	Sirmauri	srx					
sry	Sera	sry					
srz	Shahmirzadi	srz					
ssb	Southern Sama	ssb					
ssc	Suba-Simbiti	ssc					
ssd	Siroi	ssd					
sse	Balangingi	sse					
ssf	Thao	ssf					
ssg	Seimat	ssg					
ssh	Shihhi Arabic	ssh					
ssi	Sansi	ssi					
ssj	Sausi	ssj					
ssk	Sunam	ssk					
ssl	Western Sisaala	ssl					
ssm	Semnam	ssm					
ssn	Waata	ssn					
sso	Sissano	sso					
ssp	Spanish Sign Language	ssp					
ssq	So'a	ssq					
ssr	Swiss-French Sign Language	ssr					
sss	Sô	sss					
sst	Sinasina	sst					
ssu	Susuami	ssu					
ssv	Shark Bay	ssv					
ssw	Swati	ssw	ssw	ssw	ss	ss	swati;Siswati;Swazi
ssx	Samberigi	ssx					
ssy	Saho	ssy					
ssz	Sengseng	ssz					
sta	Settla	sta					
stb	Northern Subanen	stb					
std	Sentinel	std					
ste	Liana-Seti	ste					
stf	Seta	stf					
stg	Trieng	stg					
sth	Shelta	sth					
sti	Bulo Stieng	sti					
stj	Matya Samo	stj					
stk	Arammba	stk					
stl	Stellingwerfs	stl					
stm	Setaman	stm					
stn	Owa	stn					
sto	Stoney	sto					
stp	Southeastern Tepehuan	stp					
stq	Saterfriesisch	stq					
str	Straits Salish	str					
sts	Shumashti	sts					
stt	Budeh Stieng	stt					
stu	Samtao	stu					
stv	Silt'e	stv					
stw	Satawalese	stw					
sua	Sulka	sua					
sub	Suku	sub					
suc	Western Subanon	suc					
sue	Suena	sue					
sug	Suganga	sug					
sui	Suki	sui					
suj	Shubi	suj					
suk	Sukuma	suk	suk	suk			sukuma
sun	Sundanese	sun	sun	sun	su	su	Sundanesisch;soundanais
suq	Suri	suq					
sur	Mwaghavul	sur					
sus	Susu	sus	sus	sus			soussou
sut	Subtiaba	sut					
suv	Puroik	suv					
suw	Sumbwa	suw					
sux	Sumerian	sux	sux	sux			Sumerisch;sumérien
suy	Suyá	suy					
suz	Sunwar	suz					
sva	Svan	sva					Swanisch
svb	Ulau-Suain	svb					
svc	Vincentian Creole English	svc					
sve	Serili	sve					
svk	Slovakian Sign Language	svk					
svr	Savara	svr					
svs	Savosavo	svs					
svx	Skalvian	svx					
swa	Swahili	swa	swa	swa	sw	sw	Suaheli;swahili;Kiswahili;Swahili (macrolanguage)
swb	Maore Comorian	swb					
swc	Congo Swahili	swc					
swe	Swedish	swe	swe	swe	sv	sv	suédois;Schwedisch
swf	Sere	swf					
swg	Swabian	swg					
swh	Swahili (individual language)	swh					
swi	Sui	swi					
swj	Sira	swj					
swk	Malawi Sena	swk					
swl	Swedish Sign Language	swl					
swm	Samosa	swm					
swn	Sawknah	swn					
swo	Shanenawa	swo					
swp	Suau	swp					
swq	Sharwa	swq					
swr	Saweru	swr					
sws	Seluwasan	sws					
swt	Sawila	swt					
swu	Suwawa	swu					
swv	Shekhawati	swv					
sww	Sowa	sww					
swx	Suruahá	swx					
swy	Sarua	swy					
sxb	Suba	sxb					
sxc	Sicanian	sxc					
sxe	Sighu	sxe					
sxg	Shixing	sxg					
sxk	Southern Kalapuya	sxk					
sxl	Selian	sxl					
sxm	Samre	sxm					
sxn	Sangir	sxn					
sxo	Sorothaptic	sxo					
sxr	Saaroa	sxr					
sxs	Sasaru	sxs					
sxu	Upper Saxon	sxu					
sxw	Saxwe Gbe	sxw					
sya	Siang	sya					
syb	Central Subanen	syb					
syc	Classical Syriac	syc	syc	syc			syriaque classique
syi	Seki	syi					
syk	Sukur	syk					
syl	Sylheti	syl					
sym	Maya Samo	sym					
syn	Senaya	syn					
syo	Suoy	syo					
syr	Syriac	syr	syr	syr			Syrisch;syriaque
sys	Sinyar	sys					
syw	Kagate	syw					
syy	Al-Sayyid Bedouin Sign Language	syy					
sza	Semelai	sza					
szb	Ngalum	szb					
szc	Semaq Beri	szc					
szd	Seru	szd					
sze	Seze	sze					
szg	Sengele	szg					
szl	Silesian	szl					
szn	Sula	szn					
szp	Suabo	szp					
szv	Isu (Fako Division)	szv					
szw	Sawai	szw					
taa	Lower Tanana	taa					
tab	Tabassaran	tab					
tac	Lowland Tarahumara	tac					
tad	Tause	tad					
tae	Tariana	tae					
taf	Tapirapé	taf					
tag	Tagoi	tag					
tah	Tahitian	tah	tah	tah	ty	ty	Tahitianisch;Tahitisch;tahitien
taj	Eastern Tamang	taj					
tak	Tala	tak					
tal	Tal	tal					
tam	Tamil	tam	tam	tam	ta	ta	tamoul;Tamil/ Tamilisch
tan	Tangale	tan					
tao	Yami	tao					
tap	Taabwa	tap					
taq	Tamasheq	taq					
tar	Central Tarahumara	tar					
tas	Tay Boi	tas					
tat	Tatar	tat	tat	tat	tt	tt	tatar;Tatarisch
tau	Upper Tanana	tau					
tav	Tatuyo	tav					
taw	Tai	taw					
tax	Tamki	tax					
tay	Atayal	tay					
taz	Tocho	taz					
tba	Aikanã	tba					
tbb	Tapeba	tbb					
tbc	Takia	tbc					
tbd	Kaki Ae	tbd					
tbe	Tanimbili	tbe					
tbf	Mandara	tbf					
tbg	North Tairora	tbg					
tbh	Thurawal	tbh					
tbi	Gaam	tbi					
tbj	Tiang	tbj					
tbk	Calamian Tagbanwa	tbk					
tbl	Tboli	tbl					
tbm	Tagbu	tbm					
tbn	Barro Negro Tunebo	tbn					
tbo	Tawala	tbo					
tbp	Taworta	tbp					
tbr	Tumtum	tbr					
tbs	Tanguat	tbs					
tbt	Tembo (Kitembo)	tbt					
tbu	Tubar	tbu					
tbv	Tobo	tbv					
tbw	Tagbanwa	tbw					
tbx	Kapin	tbx					
tby	Tabaru	tby					
tbz	Ditammari	tbz					
tca	Ticuna	tca					
tcb	Tanacross	tcb					
tcc	Datooga	tcc					
tcd	Tafi	tcd					
tce	Southern Tutchone	tce					
tcf	Malinaltepec Me'phaa	tcf					
tcg	Tamagario	tcg					
tch	Turks And Caicos Creole English	tch					
tci	Wára	tci					
tck	Tchitchege	tck					
tcl	Taman (Myanmar)	tcl					
tcm	Tanahmerah	tcm					
tcn	Tichurong	tcn					
tco	Taungyo	tco					
tcp	Tawr Chin	tcp					
tcq	Kaiy	tcq					
tcs	Torres Strait Creole	tcs					
tct	T'en	tct					
tcu	Southeastern Tarahumara	tcu					
tcw	Tecpatlán Totonac	tcw					
tcx	Toda	tcx					
tcy	Tulu	tcy					
tcz	Thado Chin	tcz					
tda	Tagdal	tda					
tdb	Panchpargania	tdb					
tdc	Emberá-Tadó	tdc					
tdd	Tai Nüa	tdd					
tde	Tiranige Diga Dogon	tde					
tdf	Talieng	tdf					
tdg	Western Tamang	tdg					
tdh	Thulung	tdh					
tdi	Tomadino	tdi					
tdj	Tajio	tdj					
tdk	Tambas	tdk					
tdl	Sur	tdl					
tdn	Tondano	tdn					
tdo	Teme	tdo					
tdq	Tita	tdq					
tdr	Todrah	tdr					
tds	Doutai	tds					
tdt	Tetun Dili	tdt					
tdu	Tempasuk Dusun	tdu					
tdv	Toro	tdv					
tdx	Tandroy-Mahafaly Malagasy	tdx					
tdy	Tadyawan	tdy					
tea	Temiar	tea					
teb	Tetete	teb					
tec	Terik	tec					
ted	Tepo Krumen	ted					
tee	Huehuetla Tepehua	tee					
tef	Teressa	tef					
teg	Teke-Tege	teg					
teh	Tehuelche	teh					
tei	Torricelli	tei					
tek	Ibali Teke	tek					
tel	Telugu	tel	tel	tel	te	te	télougou;Telingisch
tem	Timne	tem	tem	tem			temne
ten	Tama (Colombia)	ten					
teo	Teso	teo					
tep	Tepecano	tep					
teq	Temein	teq					
ter	Tereno	ter	ter	ter			tereno
tes	Tengger	tes					
tet	Tetum	tet	tet	tet			tetum
teu	Soo	teu					
tev	Teor	tev					
tew	Tewa (USA)	tew					
tex	Tennet	tex					
tey	Tulishi	tey					
tfi	Tofin Gbe	tfi					
tfn	Tanaina	tfn					
tfo	Tefaro	tfo					
tfr	Teribe	tfr					
tft	Ternate	tft					
tga	Sagalla	tga					
tgb	Tobilung	tgb					
tgc	Tigak	tgc					
tgd	Ciwogai	tgd					
tge	Eastern Gorkha Tamang	tge					
tgf	Chalikha	tgf					
tgg	Tangga	tgg					
tgh	Tobagonian Creole English	tgh					
tgi	Lawunuia	tgi					
tgj	Tagin	tgj					
tgk	Tajik	tgk	tgk	tgk	tg	tg	Tadschikisch;tadjik
tgl	Tagalog	tgl	tgl	tgl	tl	tl	tagalog;Talalog;Tagalisch
tgn	Tandaganon	tgn					
tgo	Sudest	tgo					
tgp	Tangoa	tgp					
tgq	Tring	tgq					
tgr	Tareng	tgr					
tgs	Nume	tgs					
tgt	Central Tagbanwa	tgt					
tgu	Tanggu	tgu					
tgv	Tingui-Boto	tgv					
tgw	Tagwana Senoufo	tgw					
tgx	Tagish	tgx					
tgy	Togoyo	tgy					
tgz	Tagalaka	tgz					
tha	Thai	tha	tha	tha	th	th	thaï;Thailändisch
thc	Tai Hang Tong	thc					
thd	Thayore	thd					
the	Chitwania Tharu	the					
thf	Thangmi	thf					
thh	Northern Tarahumara	thh					
thi	Tai Long	thi					
thk	Tharaka	thk					
thl	Dangaura Tharu	thl					
thm	Aheu	thm					
thn	Thachanadan	thn					
thp	Thompson	thp					
thq	Kochila Tharu	thq					
thr	Rana Tharu	thr					
ths	Thakali	ths					
tht	Tahltan	tht					
thu	Thuri	thu					
thv	Tahaggart Tamahaq	thv					
thw	Thudam	thw					
thx	The	thx					
thy	Tha	thy					
thz	Tayart Tamajeq	thz					
tia	Tidikelt Tamazight	tia					
tic	Tira	tic					
tid	Tidong	tid					
tif	Tifal	tif					
tig	Tigre	tig	tig	tig			tigré
tih	Timugon Murut	tih					
tii	Tiene	tii					
tij	Tilung	tij					
tik	Tikar	tik					
til	Tillamook	til					
tim	Timbe	tim					
tin	Tindi	tin					
tio	Teop	tio					
tip	Trimuris	tip					
tiq	Tiéfo	tiq					
tir	Tigrinya	tir	tir	tir	ti	ti	tigrigna;Tigrinisch;Tigrinja
tis	Masadiit Itneg	tis					
tit	Tinigua	tit					
tiu	Adasen	tiu					
tiv	Tiv	tiv	tiv	tiv			tiv;Tivi
tiw	Tiwi	tiw					
tix	Southern Tiwa	tix					
tiy	Tiruray	tiy					
tiz	Tai Hongjin	tiz					
tja	Tajuasohn	tja					
tjg	Tunjung	tjg					
tji	Northern Tujia	tji					
tjl	Tai Laing	tjl					
tjm	Timucua	tjm					
tjn	Tonjon	tjn					
tjo	Temacine Tamazight	tjo					
tjs	Southern Tujia	tjs					
tju	Tjurruru	tju					
tka	Truká	tka					
tkb	Buksa	tkb					
tkd	Tukudede	tkd					
tke	Takwane	tke					
tkf	Tukumanféd	tkf					
tkg	Tesaka Malagasy	tkg					
tkl	Tokelau	tkl	tkl	tkl			Tokelauan;Tokelauisch;tokelau
tkm	Takelma	tkm					
tkn	Toku-No-Shima	tkn					
tkp	Tikopia	tkp					
tkq	Tee	tkq					
tkr	Tsakhur	tkr					
tks	Takestani	tks					
tkt	Kathoriya Tharu	tkt					
tku	Upper Necaxa Totonac	tku					
tkw	Teanu	tkw					
tkx	Tangko	tkx					
tkz	Takua	tkz					
tla	Southwestern Tepehuan	tla					
tlb	Tobelo	tlb					
tlc	Yecuatla Totonac	tlc					
tld	Talaud	tld					
tlf	Telefol	tlf					
tlg	Tofanma	tlg					
tlh	Klingon	tlh	tlh	tlh			Klingonisch;tlhIngan-Hol;klingon
tli	Tlingit	tli	tli	tli			tlingit
tlj	Talinga-Bwisi	tlj					
tlk	Taloki	tlk					
tll	Tetela	tll					
tlm	Tolomako	tlm					
tln	Talondo'	tln					
tlo	Talodi	tlo					
tlp	Filomena Mata-Coahuitlán Totonac	tlp					
tlq	Tai Loi	tlq					
tlr	Talise	tlr					
tls	Tambotalo	tls					
tlt	Teluti	tlt					
tlu	Tulehu	tlu					
tlv	Taliabu	tlv					
tlx	Khehek	tlx					
tly	Talysh	tly					
tma	Tama (Chad)	tma					
tmb	Katbol	tmb					
tmc	Tumak	tmc					
tmd	Haruai	tmd					
tme	Tremembé	tme					
tmf	Toba-Maskoy	tmf					
tmg	Ternateño	tmg					
tmh	Tamashek	tmh	tmh	tmh			tamacheq
tmi	Tutuba	tmi					
tmj	Samarokena	tmj					
tmk	Northwestern Tamang	tmk					
tml	Tamnim Citak	tml					
tmm	Tai Thanh	tmm					
tmn	Taman (Indonesia)	tmn					
tmo	Temoq	tmo					
tmp	Tai Mène	tmp					
tmq	Tumleo	tmq					
tmr	Jewish Babylonian Aramaic (ca. 200-1200 CE)	tmr					
tms	Tima	tms					
tmt	Tasmate	tmt					
tmu	Iau	tmu					
tmv	Tembo (Motembo)	tmv					
tmw	Temuan	tmw					
tmy	Tami	tmy					
tmz	Tamanaku	tmz					
tna	Tacana	tna					
tnb	Western Tunebo	tnb					
tnc	Tanimuca-Retuarã	tnc					
tnd	Angosturas Tunebo	tnd					
tne	Tinoc Kallahan	tne					
tng	Tobanga	tng					
tnh	Maiani	tnh					
tni	Tandia	tni					
tnk	Kwamera	tnk					
tnl	Lenakel	tnl					
tnm	Tabla	tnm					
tnn	North Tanna	tnn					
tno	Toromono	tno					
tnp	Whitesands	tnp					
tnq	Taino	tnq					
tnr	Bedik	tnr					
tns	Tenis	tns					
tnt	Tontemboan	tnt					
tnu	Tay Khang	tnu					
tnv	Tangchangya	tnv					
tnw	Tonsawang	tnw					
tnx	Tanema	tnx					
tny	Tongwe	tny					
tnz	Tonga (Thailand)	tnz					
tob	Toba	tob					
toc	Coyutla Totonac	toc					
tod	Toma	tod					
toe	Tomedes	toe					
tof	Gizrra	tof					
tog	Tonga (Nyasa)	tog	tog	tog			tonga (Nyasa)
toh	Gitonga	toh					
toi	Tonga (Zambia)	toi					
toj	Tojolabal	toj					
tol	Tolowa	tol					
tom	Tombulu	tom					
ton	Tonga (Tonga Islands)	ton	ton	ton	to	to	Tonganisch;Tongan;Tongaisch;tongan (Îles Tonga)
too	Xicotepec De Juárez Totonac	too					
top	Papantla Totonac	top					
toq	Toposa	toq					
tor	Togbo-Vara Banda	tor					
tos	Highland Totonac	tos					
tou	Tho	tou					
tov	Upper Taromi	tov					
tow	Jemez	tow					
tox	Tobian	tox					
toy	Topoiyo	toy					
toz	To	toz					
tpa	Taupota	tpa					
tpc	Azoyú Me'phaa	tpc					
tpe	Tippera	tpe					
tpf	Tarpia	tpf					
tpg	Kula	tpg					
tpi	Tok Pisin	tpi	tpi	tpi			tok pisin
tpj	Tapieté	tpj					
tpk	Tupinikin	tpk					
tpl	Tlacoapa Me'phaa	tpl					
tpm	Tampulma	tpm					
tpn	Tupinambá	tpn					
tpo	Tai Pao	tpo					
tpp	Pisaflores Tepehua	tpp					
tpq	Tukpa	tpq					
tpr	Tuparí	tpr					
tpt	Tlachichilco Tepehua	tpt					
tpu	Tampuan	tpu					
tpv	Tanapag	tpv					
tpw	Tupí	tpw					Tupí (Língua Geral Paulista)
tpx	Acatepec Me'phaa	tpx					
tpy	Trumai	tpy					
tpz	Tinputz	tpz					
tqb	Tembé	tqb					
tql	Lehali	tql					
tqm	Turumsa	tqm					
tqn	Tenino	tqn					
tqo	Toaripi	tqo					
tqp	Tomoip	tqp					
tqq	Tunni	tqq					
tqr	Torona	tqr					
tqt	Western Totonac	tqt					
tqu	Touo	tqu					
tqw	Tonkawa	tqw					
tra	Tirahi	tra					
trb	Terebu	trb					
trc	Copala Triqui	trc					
trd	Turi	trd					
tre	East Tarangan	tre					
trf	Trinidadian Creole English	trf					
trg	Lishán Didán	trg					
trh	Turaka	trh					
tri	Trió	tri					
trj	Toram	trj					
trl	Traveller Scottish	trl					
trm	Tregami	trm					
trn	Trinitario	trn					
tro	Tarao Naga	tro					
trp	Kok Borok	trp					
trq	San Martín Itunyoso Triqui	trq					
trr	Taushiro	trr					
trs	Chicahuaxtla Triqui	trs					
trt	Tunggare	trt					
tru	Turoyo	tru					
trv	Taroko	trv					
trw	Torwali	trw					
trx	Tringgus-Sembaan Bidayuh	trx					
try	Turung	try					
trz	Torá	trz					
tsa	Tsaangi	tsa					
tsb	Tsamai	tsb					
tsc	Tswa	tsc					
tsd	Tsakonian	tsd					
tse	Tunisian Sign Language	tse					
tsf	Southwestern Tamang	tsf					
tsg	Tausug	tsg					
tsh	Tsuvan	tsh					
tsi	Tsimshian	tsi	tsi	tsi			tsimshian
tsj	Tshangla	tsj					
tsk	Tseku	tsk					
tsl	Ts'ün-Lao	tsl					
tsm	Turkish Sign Language	tsm					
tsn	Tswana	tsn	tsn	tsn	tn	tn	tswana;Setswana
tso	Tsonga	tso	tso	tso	ts	ts	tsonga;Xitsonga
tsp	Northern Toussian	tsp					
tsq	Thai Sign Language	tsq					
tsr	Akei	tsr					
tss	Taiwan Sign Language	tss					
tst	Tondi Songway Kiini	tst					
tsu	Tsou	tsu					
tsv	Tsogo	tsv					
tsw	Tsishingini	tsw					
tsx	Mubami	tsx					
tsy	Tebul Sign Language	tsy					
tsz	Purepecha	tsz					
tta	Tutelo	tta					
ttb	Gaa	ttb					
ttc	Tektiteko	ttc					
ttd	Tauade	ttd					
tte	Bwanabwana	tte					
ttf	Tuotomb	ttf					
ttg	Tutong	ttg					
tth	Upper Ta'oih	tth					
tti	Tobati	tti					
ttj	Tooro	ttj					
ttk	Totoro	ttk					
ttl	Totela	ttl					
ttm	Northern Tutchone	ttm					
ttn	Towei	ttn					
tto	Lower Ta'oih	tto					
ttp	Tombelala	ttp					
ttq	Tawallammat Tamajaq	ttq					
ttr	Tera	ttr					
tts	Northeastern Thai	tts					
ttt	Muslim Tat	ttt					
ttu	Torau	ttu					
ttv	Titan	ttv					
ttw	Long Wat	ttw					
tty	Sikaritai	tty					
ttz	Tsum	ttz					
tua	Wiarumus	tua					
tub	Tübatulabal	tub					
tuc	Mutu	tuc					
tud	Tuxá	tud					
tue	Tuyuca	tue					
tuf	Central Tunebo	tuf					
tug	Tunia	tug					
tuh	Taulil	tuh					
tui	Tupuri	tui					
tuj	Tugutil	tuj					
tuk	Turkmen	tuk	tuk	tuk	tk	tk	Turkmenisch;turkmène
tul	Tula	tul					
tum	Tumbuka	tum	tum	tum			tumbuka
tun	Tunica	tun					
tuo	Tucano	tuo					
tuq	Tedaga	tuq					
tur	Turkish	tur	tur	tur	tr	tr	turc;Türkisch
tus	Tuscarora	tus					
tuu	Tututni	tuu					
tuv	Turkana	tuv					
tux	Tuxináwa	tux					
tuy	Tugen	tuy					
tuz	Turka	tuz					
tva	Vaghua	tva					
tvd	Tsuvadi	tvd					
tve	Te'un	tve					
tvk	Southeast Ambrym	tvk					
tvl	Tuvalu	tvl	tvl	tvl			Tuvaluan;Tuvaluisch;tuvalu
tvm	Tela-Masbuar	tvm					
tvn	Tavoyan	tvn					
tvo	Tidore	tvo					
tvs	Taveta	tvs					
tvt	Tutsa Naga	tvt					
tvu	Tunen	tvu					
tvw	Sedoa	tvw					
tvy	Timor Pidgin	tvy					
twa	Twana	twa					
twb	Western Tawbuid	twb					
twc	Teshenawa	twc					
twd	Twents	twd					
twe	Tewa (Indonesia)	twe					
twf	Northern Tiwa	twf					
twg	Tereweng	twg					
twh	Tai Dón	twh					
twi	Twi	twi	twi	twi	tw	tw	twi
twl	Tawara	twl					
twm	Tawang Monpa	twm					
twn	Twendi	twn					
two	Tswapong	two					
twp	Ere	twp					
twq	Tasawaq	twq					
twr	Southwestern Tarahumara	twr					
twt	Turiwára	twt					
twu	Termanu	twu					
tww	Tuwari	tww					
twx	Tewe	twx					
twy	Tawoyan	twy					
txa	Tombonuo	txa					
txb	Tokharian B	txb					Tocharian B
txc	Tsetsaut	txc					
txe	Totoli	txe					
txg	Tangut	txg					
txh	Thracian	txh					
txi	Ikpeng	txi					
txm	Tomini	txm					
txn	West Tarangan	txn					
txo	Toto	txo					
txq	Tii	txq					
txr	Tartessian	txr					
txs	Tonsea	txs					
txt	Citak	txt					
txu	Kayapó	txu					
txx	Tatana	txx					
txy	Tanosy Malagasy	txy					
tya	Tauya	tya					
tye	Kyenga	tye					
tyh	O'du	tyh					
tyi	Teke-Tsaayi	tyi					
tyj	Tai Do	tyj					
tyl	Thu Lao	tyl					
tyn	Kombai	tyn					
typ	Thaypan	typ					
tyr	Tai Daeng	tyr					
tys	Tày Sa Pa	tys					
tyt	Tày Tac	tyt					
tyu	Kua	tyu					
tyv	Tuvinian	tyv	tyv	tyv			touva;Tuwinisch;Tuvan
tyx	Teke-Tyee	tyx					
tyz	Tày	tyz					
tza	Tanzanian Sign Language	tza					
tzh	Tzeltal	tzh					
tzj	Tz'utujil	tzj					
tzm	Central Atlas Tamazight	tzm					
tzn	Tugun	tzn					
tzo	Tzotzil	tzo					
tzx	Tabriak	tzx					
uam	Uamué	uam					
uan	Kuan	uan					
uar	Tairuma	uar					
uba	Ubang	uba					
ubi	Ubi	ubi					
ubl	Buhi'non Bikol	ubl					
ubr	Ubir	ubr					
ubu	Umbu-Ungu	ubu					
uby	Ubykh	uby					
uda	Uda	uda					
ude	Udihe	ude					
udg	Muduga	udg					
udi	Udi	udi					
udj	Ujir	udj					
udl	Wuzlam	udl					
udm	Udmurt	udm	udm	udm			oudmourte;Udmurtisch
udu	Uduk	udu					
ues	Kioko	ues					
ufi	Ufim	ufi					
uga	Ugaritic	uga	uga	uga			ougaritique
ugb	Kuku-Ugbanh	ugb					
uge	Ughele	uge					
ugn	Ugandan Sign Language	ugn					
ugo	Ugong	ugo					
ugy	Uruguayan Sign Language	ugy					
uha	Uhami	uha					
uhn	Damal	uhn					
uig	Uighur	uig	uig	uig	ug	ug	Uyghur;ouïgour;Uigurisch
uis	Uisai	uis					
uiv	Iyive	uiv					
uji	Tanjijili	uji					
uka	Kaburi	uka					
ukg	Ukuriguma	ukg					
ukh	Ukhwejo	ukh					
ukl	Ukrainian Sign Language	ukl					
ukp	Ukpe-Bayobiri	ukp					
ukq	Ukwa	ukq					
ukr	Ukrainian	ukr	ukr	ukr	uk	uk	Ukrainisch;ukrainien
uks	Urubú-Kaapor Sign Language	uks					
uku	Ukue	uku					
ukw	Ukwuani-Aboh-Ndoni	ukw					
uky	Kuuk-Yak	uky					
ula	Fungwa	ula					
ulb	Ulukwumi	ulb					
ulc	Ulch	ulc					
ulf	Usku	ulf					
uli	Ulithian	uli					
ulk	Meriam	ulk					
ull	Ullatan	ull					
ulm	Ulumanda'	ulm					
uln	Unserdeutsch	uln					
ulu	Uma' Lung	ulu					
ulw	Ulwa	ulw					
uma	Umatilla	uma					
umb	Umbundu	umb	umb	umb			umbundu
umc	Marrucinian	umc					
umd	Umbindhamu	umd					
umg	Umbuygamu	umg					
umi	Ukit	umi					
umm	Umon	umm					
umn	Makyan Naga	umn					
umo	Umotína	umo					
ump	Umpila	ump					
umr	Umbugarla	umr					
ums	Pendau	ums					
umu	Munsee	umu					
una	North Watut	una					
und	Undetermined	und	und	und			indéterminée
une	Uneme	une					
ung	Ngarinyin	ung					
unk	Enawené-Nawé	unk					
unm	Unami	unm					
unr	Mundari	unr					
unx	Munda	unx					
unz	Unde Kaili	unz					
uok	Uokha	uok					
upi	Umeda	upi					
upv	Uripiv-Wala-Rano-Atchin	upv					
ura	Urarina	ura					
urb	Urubú-Kaapor	urb					
urc	Urningangg	urc					
urd	Urdu	urd	urd	urd	ur	ur	ourdou
ure	Uru	ure					
urf	Uradhi	urf					
urg	Urigina	urg					
urh	Urhobo	urh					
uri	Urim	uri					
urk	Urak Lawoi'	urk					
url	Urali	url					
urm	Urapmin	urm					
urn	Uruangnirin	urn					
uro	Ura (Papua New Guinea)	uro					
urp	Uru-Pa-In	urp					
urr	Lehalurup	urr					
urt	Urat	urt					
uru	Urumi	uru					
urv	Uruava	urv					
urw	Sop	urw					
urx	Urimo	urx					
ury	Orya	ury					
urz	Uru-Eu-Wau-Wau	urz					
usa	Usarufa	usa					
ush	Ushojo	ush					
usi	Usui	usi					
usk	Usaghade	usk					
usp	Uspanteco	usp					
usu	Uya	usu					
uta	Otank	uta					
ute	Ute-Southern Paiute	ute					
utp	Amba (Solomon Islands)	utp					
utr	Etulo	utr					
utu	Utu	utu					
uum	Urum	uum					
uun	Kulon-Pazeh	uun					
uur	Ura (Vanuatu)	uur					
uuu	U	uuu					
uve	West Uvean	uve					
uvh	Uri	uvh					
uvl	Lote	uvl					
uwa	Kuku-Uwanh	uwa					
uya	Doko-Uyanga	uya					
uzb	Uzbek	uzb	uzb	uzb	uz	uz	ouszbek;Usbekisch
uzn	Northern Uzbek	uzn					
uzs	Southern Uzbek	uzs					
vaa	Vaagri Booli	vaa					
vae	Vale	vae					
vaf	Vafsi	vaf					
vag	Vagla	vag					
vah	Varhadi-Nagpuri	vah					
vai	Vai	vai	vai	vai			vaï
vaj	Vasekela Bushman	vaj					
val	Vehes	val					
vam	Vanimo	vam					
van	Valman	van					
vao	Vao	vao					
vap	Vaiphei	vap					
var	Huarijio	var					
vas	Vasavi	vas					
vau	Vanuma	vau					
vav	Varli	vav					
vay	Wayu	vay					
vbb	Southeast Babar	vbb					
vbk	Southwestern Bontok	vbk					
vec	Venetian	vec					Venezianisch
ved	Veddah	ved					
vel	Veluws	vel					
vem	Vemgo-Mabas	vem					
ven	Venda	ven	ven	ven	ve	ve	venda;Tshivenda
veo	Ventureño	veo					
vep	Veps	vep					Wepsisch
ver	Mom Jango	ver					
vgr	Vaghri	vgr					
vgt	Vlaamse Gebarentaal	vgt					
vic	Virgin Islands Creole English	vic					
vid	Vidunda	vid					
vie	Vietnamese	vie	vie	vie	vi	vi	vietnamien;Vietnamesisch
vif	Vili	vif					
vig	Viemo	vig					
vil	Vilela	vil					
vin	Vinza	vin					
vis	Vishavan	vis					
vit	Viti	vit					
viv	Iduna	viv					
vka	Kariyarra	vka					
vki	Ija-Zuba	vki					
vkj	Kujarge	vkj					
vkk	Kaur	vkk					
vkl	Kulisusu	vkl					
vkm	Kamakan	vkm					
vko	Kodeoha	vko					
vkp	Korlai Creole Portuguese	vkp					
vkt	Tenggarong Kutai Malay	vkt					
vku	Kurrama	vku					
vlp	Valpei	vlp					
vls	Vlaams	vls					Westflämisch
vma	Martuyhunira	vma					Martuthunira
vmb	Mbabaram	vmb					
vmc	Juxtlahuaca Mixtec	vmc					
vmd	Mudu Koraga	vmd					
vme	East Masela	vme					
vmf	Mainfränkisch	vmf					
vmg	Minigir	vmg					
vmh	Maraghei	vmh					
vmi	Miwa	vmi					
vmj	Ixtayutla Mixtec	vmj					
vmk	Makhuwa-Shirima	vmk					
vml	Malgana	vml					
vmm	Mitlatongo Mixtec	vmm					
vmp	Soyaltepec Mazatec	vmp					
vmq	Soyaltepec Mixtec	vmq					
vmr	Marenje	vmr					
vms	Moksela	vms					
vmu	Muluridyi	vmu					
vmv	Valley Maidu	vmv					
vmw	Makhuwa	vmw					
vmx	Tamazola Mixtec	vmx					
vmy	Ayautla Mazatec	vmy					
vmz	Mazatlán Mazatec	vmz					
vnk	Vano	vnk					
vnm	Vinmavis	vnm					
vnp	Vunapu	vnp					
vol	Volapük	vol	vol	vol	vo	vo	volapük
vor	Voro	vor				fiu-vor	Võro
vot	Votic	vot	vot	vot			Wotisch;vote
vra	Vera'a	vra					
vro	Võro	vro					
vrs	Varisi	vrs					
vrt	Burmbar	vrt					
vsi	Moldova Sign Language	vsi					
vsl	Venezuelan Sign Language	vsl					
vsv	Valencian Sign Language	vsv					
vto	Vitou	vto					
vum	Vumbu	vum					
vun	Vunjo	vun					
vut	Vute	vut					
vwa	Awa (China)	vwa					
waa	Walla Walla	waa					
wab	Wab	wab					
wac	Wasco-Wishram	wac					
wad	Wandamen	wad					
wae	Walser	wae					
waf	Wakoná	waf					
wag	Wa'ema	wag					
wah	Watubela	wah					
wai	Wares	wai					
waj	Waffa	waj					
wal	Wolaytta	wal	wal	wal			wolaitta;Wolaitta;Walamo;wolaytta
wam	Wampanoag	wam					
wan	Wan	wan					
wao	Wappo	wao					
wap	Wapishana	wap					
waq	Wageman	waq					
war	Waray (Philippines)	war	war	war			Waray;waray
was	Washo	was	was	was			washo
wat	Kaninuwa	wat					
wau	Waurá	wau					
wav	Waka	wav					
waw	Waiwai	waw					
wax	Watam	wax					
way	Wayana	way					
waz	Wampur	waz					
wba	Warao	wba					
wbb	Wabo	wbb					
wbe	Waritai	wbe					
wbf	Wara	wbf					
wbh	Wanda	wbh					
wbi	Vwanji	wbi					
wbj	Alagwa	wbj					
wbk	Waigali	wbk					
wbl	Wakhi	wbl					
wbm	Wa	wbm					
wbp	Warlpiri	wbp					
wbq	Waddar	wbq					
wbr	Wagdi	wbr					
wbt	Wanman	wbt					
wbv	Wajarri	wbv					
wbw	Woi	wbw					
wca	Yanomámi	wca					
wci	Waci Gbe	wci					
wdd	Wandji	wdd					
wdg	Wadaginam	wdg					
wdj	Wadjiginy	wdj					
wdu	Wadjigu	wdu					
wea	Wewaw	wea					
wec	Wè Western	wec					
wed	Wedau	wed					
weh	Weh	weh					
wei	Kiunum	wei					
wem	Weme Gbe	wem					
weo	Wemale	weo					
wep	Westphalien	wep					
wer	Weri	wer					
wes	Cameroon Pidgin	wes					
wet	Perai	wet					
weu	Rawngtu Chin	weu					
wew	Wejewa	wew					
wfg	Yafi	wfg					
wga	Wagaya	wga					
wgb	Wagawaga	wgb					
wgg	Wangganguru	wgg					
wgi	Wahgi	wgi					
wgo	Waigeo	wgo					
wgu	Wirangu	wgu					
wgy	Warrgamay	wgy					
wha	Manusela	wha					
whg	North Wahgi	whg					
whk	Wahau Kenyah	whk					
whu	Wahau Kayan	whu					
wib	Southern Toussian	wib					
wic	Wichita	wic					
wie	Wik-Epa	wie					
wif	Wik-Keyangan	wif					
wig	Wik-Ngathana	wig					
wih	Wik-Me'anha	wih					
wii	Minidien	wii					
wij	Wik-Iiyanh	wij					
wik	Wikalkan	wik					
wil	Wilawila	wil					
wim	Wik-Mungkan	wim					
win	Ho-Chunk	win					
wir	Wiraféd	wir					
wit	Wintu	wit					
wiu	Wiru	wiu					
wiv	Vitu	wiv					Muduapa
wiy	Wiyot	wiy					
wja	Waja	wja					
wji	Warji	wji					
wka	Kw'adza	wka					
wkb	Kumbaran	wkb					
wkd	Wakde	wkd					
wkl	Kalanadi	wkl					
wku	Kunduvadi	wku					
wkw	Wakawaka	wkw					
wla	Walio	wla					
wlc	Mwali Comorian	wlc					
wle	Wolane	wle					
wlg	Kunbarlang	wlg					
wli	Waioli	wli					
wlk	Wailaki	wlk					
wll	Wali (Sudan)	wll					
wlm	Middle Welsh	wlm					
wln	Walloon	wln	wln	wln	wa	wa	Wallonisch;Wallon;wallon
wlo	Wolio	wlo					
wlr	Wailapa	wlr					
wls	Wallisian	wls					
wlu	Wuliwuli	wlu					
wlv	Wichí Lhamtés Vejoz	wlv					
wlw	Walak	wlw					
wlx	Wali (Ghana)	wlx					
wly	Waling	wly					
wma	Mawa (Nigeria)	wma					
wmb	Wambaya	wmb					
wmc	Wamas	wmc					
wmd	Mamaindé	wmd					
wme	Wambule	wme					
wmh	Waima'a	wmh					
wmi	Wamin	wmi					
wmm	Maiwa (Indonesia)	wmm					
wmn	Waamwang	wmn					
wmo	Wom (Papua New Guinea)	wmo					
wms	Wambon	wms					
wmt	Walmajarri	wmt					
wmw	Mwani	wmw					
wmx	Womo	wmx					
wnb	Wanambre	wnb					
wnc	Wantoat	wnc					
wnd	Wandarang	wnd					
wne	Waneci	wne					
wng	Wanggom	wng					
wni	Ndzwani Comorian	wni					
wnk	Wanukaka	wnk					
wnm	Wanggamala	wnm					
wno	Wano	wno					
wnp	Wanap	wnp					
wnu	Usan	wnu					
wny	Wanyi	wny					
woa	Tyaraity	woa					
wob	Wè Northern	wob					
woc	Wogeo	woc					
wod	Wolani	wod					
woe	Woleaian	woe					
wof	Gambian Wolof	wof					
wog	Wogamusin	wog					
woi	Kamang	woi					
wok	Longto	wok					
wol	Wolof	wol	wol	wol	wo	wo	wolof
wom	Wom (Nigeria)	wom					
won	Wongo	won					
woo	Manombai	woo					
wor	Woria	wor					
wos	Hanga Hundi	wos					
wow	Wawonii	wow					
woy	Weyto	woy					
wpc	Maco	wpc					
wra	Warapu	wra					
wrb	Warluwara	wrb					
wrd	Warduji	wrd					
wrg	Warungu	wrg					
wrh	Wiradhuri	wrh					
wri	Wariyangga	wri					
wrk	Garrwa	wrk					
wrl	Warlmanpa	wrl					
wrm	Warumungu	wrm					
wrn	Warnang	wrn					
wro	Worrorra	wro					
wrp	Waropen	wrp					
wrr	Wardaman	wrr					
wrs	Waris	wrs					
wru	Waru	wru					
wrv	Waruna	wrv					
wrw	Gugu Warra	wrw					
wrx	Wae Rana	wrx					
wry	Merwari	wry					
wrz	Waray (Australia)	wrz					
wsa	Warembori	wsa					
wsi	Wusi	wsi					
wsk	Waskia	wsk					
wsr	Owenia	wsr					
wss	Wasa	wss					
wsu	Wasu	wsu					
wsv	Wotapuri-Katarqalai	wsv					
wtf	Watiwa	wtf					
wti	Berta	wti					
wtk	Watakataui	wtk					
wtm	Mewati	wtm					
wtw	Wotu	wtw					
wua	Wikngenchera	wua					
wub	Wunambal	wub					
wud	Wudu	wud					
wuh	Wutunhua	wuh					
wul	Silimo	wul					
wum	Wumbvu	wum					
wun	Bungu	wun					
wur	Wurrugu	wur					
wut	Wutung	wut					
wuu	Wu Chinese	wuu					Wu;Wu (Suzhou dialect)
wuv	Wuvulu-Aua	wuv					
wux	Wulna	wux					
wuy	Wauyai	wuy					
wwa	Waama	wwa					
wwb	Wakabunga	wwb					
wwo	Wetamut	wwo					
wwr	Warrwa	wwr					
www	Wawa	www					
wxa	Waxianghua	wxa					
wya	Wyandot	wya					
wyb	Wangaaybuwan-Ngiyambaa	wyb					
wym	Wymysorys	wym					
wyr	Wayoró	wyr					
wyy	Western Fijian	wyy					
xaa	Andalusian Arabic	xaa					
xab	Sambe	xab					
xac	Kachari	xac					
xad	Adai	xad					
xae	Aequian	xae					
xag	Aghwan	xag					
xai	Kaimbé	xai					
xal	Kalmyk	xal	xal	xal			Oirat;oïrat;Kalmückisch;kalmouk
xam	/Xam	xam					
xan	Xamtanga	xan					
xao	Khao	xao					
xap	Apalachee	xap					
xaq	Aquitanian	xaq					
xar	Karami	xar					
xas	Kamas	xas					
xat	Katawixi	xat					
xau	Kauwera	xau					
xav	Xavánte	xav					
xaw	Kawaiisu	xaw					
xay	Kayan Mahakam	xay					
xba	Kamba (Brazil)	xba					
xbb	Lower Burdekin	xbb					
xbc	Bactrian	xbc					
xbi	Kombio	xbi					
xbm	Middle Breton	xbm					
xbn	Kenaboi	xbn					
xbo	Bolgarian	xbo					
xbr	Kambera	xbr					
xbw	Kambiwá	xbw					
xbx	Kabixí	xbx					
xcb	Cumbric	xcb					
xcc	Camunic	xcc					
xce	Celtiberian	xce					
xcg	Cisalpine Gaulish	xcg					
xch	Chemakum	xch					
xcl	Classical Armenian	xcl					Old Armenian
xcm	Comecrudo	xcm					
xcn	Cotoname	xcn					
xco	Chorasmian	xco					
xcr	Carian	xcr					
xct	Classical Tibetan	xct					
xcu	Curonian	xcu					
xcv	Chuvantsy	xcv					
xcw	Coahuilteco	xcw					
xcy	Cayuse	xcy					
xdc	Dacian	xdc					
xdm	Edomite	xdm					
xdy	Malayic Dayak	xdy					
xeb	Eblan	xeb					
xed	Hdi	xed					
xeg	//Xegwi	xeg					
xel	Kelo	xel					
xem	Kembayan	xem					
xep	Epi-Olmec	xep					
xer	Xerénte	xer					
xes	Kesawai	xes					
xet	Xetá	xet					
xeu	Keoru-Ahia	xeu					
xfa	Faliscan	xfa					
xga	Galatian	xga					
xgb	Gbin	xgb					
xgf	Gabrielino-Fernandeño	xgf					
xgl	Galindan	xgl					
xgr	Garza	xgr					
xgu	Unggumi	xgu					
xha	Harami	xha					
xhc	Hunnic	xhc					
xhd	Hadrami	xhd					
xhe	Khetrani	xhe					
xho	Xhosa	xho	xho	xho	xh	xh	xhosa;isiXhosa
xhr	Hernican	xhr					
xht	Hattic	xht					
xhu	Hurrian	xhu					Hurritisch
xhv	Khua	xhv					
xia	Xiandao	xia					
xib	Iberian	xib					
xii	Xiri	xii					
xil	Illyrian	xil					
xin	Xinca	xin					
xip	Xipináwa	xip					
xir	Xiriâna	xir					
xiv	Indus Valley Language	xiv					
xiy	Xipaya	xiy					
xka	Kalkoti	xka					
xkb	Northern Nago	xkb					
xkc	Kho'ini	xkc					
xkd	Mendalam Kayan	xkd					
xke	Kereho	xke					
xkf	Khengkha	xkf					
xkg	Kagoro	xkg					
xkh	Karahawyana	xkh					
xki	Kenyan Sign Language	xki					
xkj	Kajali	xkj					
xkk	Kaco'	xkk					
xkl	Mainstream Kenyah	xkl					
xkn	Kayan River Kayan	xkn					
xko	Kiorr	xko					
xkp	Kabatei	xkp					
xkq	Koroni	xkq					
xkr	Xakriabá	xkr					
xks	Kumbewaha	xks					
xkt	Kantosi	xkt					
xku	Kaamba	xku					
xkv	Kgalagadi	xkv					
xkw	Kembra	xkw					
xkx	Karore	xkx					
xky	Uma' Lasan	xky					
xkz	Kurtokha	xkz					
xla	Kamula	xla					
xlb	Loup B	xlb					
xlc	Lycian	xlc					
xld	Lydian	xld					
xle	Lemnian	xle					
xlg	Ligurian (Ancient)	xlg					
xli	Liburnian	xli					
xln	Alanic	xln					
xlo	Loup A	xlo					
xlp	Lepontic	xlp					
xls	Lusitanian	xls					
xlu	Cuneiform Luwian	xlu					Luwisch
xly	Elymian	xly					
xma	Mushungulu	xma					
xmb	Mbonga	xmb					
xmc	Makhuwa-Marrevone	xmc					
xmd	Mbudum	xmd					
xme	Median	xme					
xmf	Mingrelian	xmf					
xmg	Mengaka	xmg					
xmh	Kuku-Muminh	xmh					
xmj	Majera	xmj					
xmk	Ancient Macedonian	xmk					
xml	Malaysian Sign Language	xml					
xmm	Manado Malay	xmm					
xmn	Manichaean Middle Persian	xmn					
xmo	Morerebi	xmo					
xmp	Kuku-Mu'inh	xmp					
xmq	Kuku-Mangk	xmq					
xmr	Meroitic	xmr					
xms	Moroccan Sign Language	xms					
xmt	Matbat	xmt					
xmu	Kamu	xmu					
xmv	Antankarana Malagasy	xmv					
xmw	Tsimihety Malagasy	xmw					
xmx	Maden	xmx					
xmy	Mayaguduna	xmy					
xmz	Mori Bawah	xmz					
xna	Ancient North Arabian	xna					
xnb	Kanakanabu	xnb					
xng	Middle Mongolian	xng					
xnh	Kuanhua	xnh					
xnn	Northern Kankanay	xnn					
xno	Anglo-Norman	xno					
xnr	Kangri	xnr					
xns	Kanashi	xns					
xnt	Narragansett	xnt					
xnz	Kenzi	xnz					
xoc	O'chi'chi'	xoc					
xod	Kokoda	xod					
xog	Soga	xog					
xoi	Kominimung	xoi					
xok	Xokleng	xok					
xom	Komo (Sudan)	xom					
xon	Konkomba	xon					
xoo	Xukurú	xoo					
xop	Kopar	xop					
xor	Korubo	xor					
xow	Kowaki	xow					
xpc	Pecheneg	xpc					
xpe	Liberia Kpelle	xpe					
xpg	Phrygian	xpg					
xpi	Pictish	xpi					
xpj	Mpalitjanh	xpj					
xpk	Kulina Pano	xpk					
xpm	Pumpokol	xpm					
xpn	Kapinawá	xpn					
xpo	Pochutec	xpo					
xpp	Puyo-Paekche	xpp					
xpq	Mohegan-Pequot	xpq					
xpr	Parthian	xpr					
xps	Pisidian	xps					
xpu	Punic	xpu					
xpy	Puyo	xpy					
xqa	Karakhanid	xqa					
xqt	Qatabanian	xqt					
xra	Krahô	xra					
xrb	Eastern Karaboro	xrb					
xre	Kreye	xre					
xri	Krikati-Timbira	xri					
xrm	Armazic	xrm					
xrn	Arin	xrn					
xrr	Raetic	xrr					
xrt	Aranama-Tamique	xrt					
xru	Marriammu	xru					
xrw	Karawa	xrw					
xsa	Sabaean	xsa					
xsb	Sambal	xsb					
xsc	Scythian	xsc					
xsd	Sidetic	xsd					
xse	Sempan	xse					
xsh	Shamang	xsh					
xsi	Sio	xsi					
xsj	Subi	xsj					
xsl	South Slavey	xsl					
xsm	Kasem	xsm					
xsn	Sanga (Nigeria)	xsn					
xso	Solano	xso					
xsp	Silopi	xsp					
xsq	Makhuwa-Saka	xsq					
xsr	Sherpa	xsr					
xss	Assan	xss					
xsu	Sanumá	xsu					
xsv	Sudovian	xsv					
xsy	Saisiyat	xsy					
xta	Alcozauca Mixtec	xta					
xtb	Chazumba Mixtec	xtb					
xtc	Katcha-Kadugli-Miri	xtc					
xtd	Diuxi-Tilantongo Mixtec	xtd					
xte	Ketengban	xte					
xtg	Transalpine Gaulish	xtg					
xti	Sinicahua Mixtec	xti					
xtj	San Juan Teita Mixtec	xtj					
xtl	Tijaltepec Mixtec	xtl					
xtm	Magdalena Peñasco Mixtec	xtm					
xtn	Northern Tlaxiaco Mixtec	xtn					
xto	Tokharian A	xto					Tocharian A
xtp	San Miguel Piedras Mixtec	xtp					
xtq	Tumshuqese	xtq					
xtr	Early Tripuri	xtr					
xts	Sindihui Mixtec	xts					
xtt	Tacahua Mixtec	xtt					
xtu	Cuyamecalco Mixtec	xtu					
xtw	Tawandê	xtw					
xty	Yoloxochitl Mixtec	xty					
xtz	Tasmanian	xtz					
xua	Alu Kurumba	xua					
xub	Betta Kurumba	xub					
xud	Umiida	xud					
xug	Kunigami	xug					
xuj	Jennu Kurumba	xuj					
xum	Umbrian	xum					
xun	Unggarranggu	xun					
xuo	Kuo	xuo					
xup	Upper Umpqua	xup					
xur	Urartian	xur					Urartäisch
xut	Kuthant	xut					
xuu	Kxoe	xuu					
xve	Venetic	xve					Venetisch
xvi	Kamviri	xvi					
xvn	Vandalic	xvn					
xvo	Volscian	xvo					
xvs	Vestinian	xvs					
xwa	Kwaza	xwa					
xwc	Woccon	xwc					
xwe	Xwela Gbe	xwe					
xwg	Kwegu	xwg					
xwl	Western Xwla Gbe	xwl					
xwo	Written Oirat	xwo					
xwr	Kwerba Mamberamo	xwr					
xxb	Boro (Ghana)	xxb					
xxk	Ke'o	xxk					
xxr	Koropó	xxr					
xxt	Tambora	xxt					
xyl	Yalakalore	xyl					
xyy	Yorta Yorta	xyy					
xzh	Zhang-Zhung	xzh					
xzm	Zemgalian	xzm					
xzp	Ancient Zapotec	xzp					
yaa	Yaminahua	yaa					
yab	Yuhup	yab					
yac	Pass Valley Yali	yac					
yad	Yagua	yad					
yae	Pumé	yae					
yaf	Yaka (Democratic Republic of Congo)	yaf					
yag	Yámana	yag					
yah	Yazgulyam	yah					
yai	Yagnobi	yai					
yaj	Banda-Yangere	yaj					
yak	Yakama	yak					
yal	Yalunka	yal					
yam	Yamba	yam					
yan	Mayangna	yan					
yao	Yao	yao	yao	yao			yao
yap	Yapese	yap	yap	yap			yapois
yaq	Yaqui	yaq					
yar	Yabarana	yar					
yas	Nugunu (Cameroon)	yas					
yat	Yambeta	yat					
yau	Yuwana	yau					
yav	Yangben	yav					
yaw	Yawalapití	yaw					
yax	Yauma	yax					
yay	Agwagwune	yay					
yaz	Lokaa	yaz					
yba	Yala	yba					
ybb	Yemba	ybb					
ybe	West Yugur	ybe					
ybh	Yakha	ybh					
ybi	Yamphu	ybi					
ybj	Hasha	ybj					
ybk	Bokha	ybk					
ybl	Yukuben	ybl					
ybm	Yaben	ybm					
ybn	Yabaâna	ybn					
ybo	Yabong	ybo					
ybx	Yawiyo	ybx					
yby	Yaweyuha	yby					
ych	Chesu	ych					
ycl	Lolopo	ycl					
ycn	Yucuna	ycn					
ycp	Chepya	ycp					
ydd	Eastern Yiddish	ydd					
yde	Yangum Dey	yde					
ydg	Yidgha	ydg					
ydk	Yoidik	ydk					
yds	Yiddish Sign Language	yds					
yea	Ravula	yea					
yec	Yeniche	yec					
yee	Yimas	yee					
yei	Yeni	yei					
yej	Yevanic	yej					
yel	Yela	yel					
yer	Tarok	yer					
yes	Nyankpa	yes					
yet	Yetfa	yet					
yeu	Yerukula	yeu					
yev	Yapunda	yev					
yey	Yeyi	yey					
yga	Malyangapa	yga					
ygl	Yangum Gel	ygl					
ygm	Yagomi	ygm					
ygp	Gepo	ygp					
ygr	Yagaria	ygr					
ygw	Yagwoia	ygw					
yha	Baha Buyang	yha					
yhd	Judeo-Iraqi Arabic	yhd					
yhl	Hlepho Phowa	yhl					
yia	Yinggarda	yia					
yid	Yiddish	yid	yid	yid	yi	yi	Jiddisch;yiddish
yif	Ache	yif					
yig	Wusa Nasu	yig					
yih	Western Yiddish	yih					
yii	Yidiny	yii					
yij	Yindjibarndi	yij					
yik	Dongshanba Lalo	yik					
yil	Yindjilandji	yil					
yim	Yimchungru Naga	yim					
yin	Yinchia	yin					
yip	Pholo	yip					
yiq	Miqie	yiq					
yir	North Awyu	yir					
yis	Yis	yis					
yit	Eastern Lalu	yit					
yiu	Awu	yiu					
yiv	Northern Nisu	yiv					
yix	Axi Yi	yix					
yiy	Yir Yoront	yiy					
yiz	Azhe	yiz					
yka	Yakan	yka					
ykg	Northern Yukaghir	ykg					
yki	Yoke	yki					
ykk	Yakaikeke	ykk					
ykl	Khlula	ykl					
ykm	Kap	ykm					
ykn	Kua-nsi	ykn					
yko	Yasa	yko					
ykr	Yekora	ykr					
ykt	Kathu	ykt					
yku	Kuamasi	yku					
yky	Yakoma	yky					
yla	Yaul	yla					
ylb	Yaleba	ylb					
yle	Yele	yle					
ylg	Yelogu	ylg					
yli	Angguruk Yali	yli					
yll	Yil	yll					
ylm	Limi	ylm					
yln	Langnian Buyang	yln					
ylo	Naluo Yi	ylo					
ylr	Yalarnnga	ylr					
ylu	Aribwaung	ylu					
yly	Nyâlayu	yly					
ymb	Yambes	ymb					
ymc	Southern Muji	ymc					
ymd	Muda	ymd					
yme	Yameo	yme					
ymg	Yamongeri	ymg					
ymh	Mili	ymh					
ymi	Moji	ymi					
ymk	Makwe	ymk					
yml	Iamalele	yml					
ymm	Maay	ymm					
ymn	Yamna	ymn					
ymo	Yangum Mon	ymo					
ymp	Yamap	ymp					
ymq	Qila Muji	ymq					
ymr	Malasar	ymr					
yms	Mysian	yms					
ymt	Mator-Taygi-Karagas	ymt					
ymx	Northern Muji	ymx					
ymz	Muzi	ymz					
yna	Aluo	yna					
ynd	Yandruwandha	ynd					
yne	Lang'e	yne					
yng	Yango	yng					
ynh	Yangho	ynh					
ynk	Naukan Yupik	ynk					
ynl	Yangulam	ynl					
ynn	Yana	ynn					
yno	Yong	yno					
ynq	Yendang	ynq					
yns	Yansi	yns					
ynu	Yahuna	ynu					
yob	Yoba	yob					
yog	Yogad	yog					
yoi	Yonaguni	yoi					
yok	Yokuts	yok					
yol	Yola	yol					
yom	Yombe	yom					
yon	Yongkom	yon					
yor	Yoruba	yor	yor	yor	yo	yo	yoruba;Joruba
yos	Yos	yos					
yot	Yotti	yot					
yox	Yoron	yox					
yoy	Yoy	yoy					
ypa	Phala	ypa					
ypb	Labo Phowa	ypb					
ypg	Phola	ypg					
yph	Phupha	yph					
ypm	Phuma	ypm					
ypn	Ani Phowa	ypn					
ypo	Alo Phola	ypo					
ypp	Phupa	ypp					
ypz	Phuza	ypz					
yra	Yerakai	yra					
yrb	Yareba	yrb					
yre	Yaouré	yre					
yri	Yarí	yri					
yrk	Nenets	yrk					
yrl	Nhengatu	yrl					
yrn	Yerong	yrn					
yrs	Yarsun	yrs					
yrw	Yarawata	yrw					
ysc	Yassic	ysc					
ysd	Samatao	ysd					
ysg	Sonaga	ysg					
ysl	Yugoslavian Sign Language	ysl					
ysn	Sani	ysn					
yso	Nisi (China)	yso					
ysp	Southern Lolopo	ysp					
ysr	Sirenik Yupik	ysr					
yss	Yessan-Mayo	yss					
ysy	Sanie	ysy					
yta	Talu	yta					
ytl	Tanglang	ytl					
ytp	Thopho	ytp					
ytw	Yout Wam	ytw					
yua	Yucateco	yua					Yucatec
yub	Yugambal	yub					
yuc	Yuchi	yuc					
yud	Judeo-Tripolitanian Arabic	yud					
yue	Yue Chinese	yue					Kantonesisch
yuf	Havasupai-Walapai-Yavapai	yuf					
yug	Yug	yug					
yui	Yurutí	yui					
yuj	Karkar-Yuri	yuj					
yuk	Yuki	yuk					
yul	Yulu	yul					
yum	Quechan	yum					
yun	Bena (Nigeria)	yun					
yup	Yukpa	yup					
yuq	Yuqui	yuq					
yur	Yurok	yur					
yut	Yopno	yut					
yuu	Yugh	yuu					
yuw	Yau (Morobe Province)	yuw					
yux	Southern Yukaghir	yux					
yuy	East Yugur	yuy					
yuz	Yuracare	yuz					
yva	Yawa	yva					
yvt	Yavitero	yvt					
ywa	Kalou	ywa					
ywl	Western Lalu	ywl					
ywn	Yawanawa	ywn					
ywq	Wuding-Luquan Yi	ywq					
ywr	Yawuru	ywr					
ywt	Xishanba Lalo	ywt					
ywu	Wumeng Nasu	ywu					
yww	Yawarawarga	yww					
yxg	Yagara	yxg					
yxy	Yabula Yabula	yxy					
yyu	Yau (Sandaun Province)	yyu					
yyz	Ayizi	yyz					
yzg	E'ma Buyang	yzg					
yzk	Zokhuo	yzk					
zaa	Sierra de Juárez Zapotec	zaa					
zab	San Juan Guelavía Zapotec	zab					
zac	Ocotlán Zapotec	zac					
zad	Cajonos Zapotec	zad					
zae	Yareni Zapotec	zae					
zaf	Ayoquesco Zapotec	zaf					
zag	Zaghawa	zag					
zah	Zangwal	zah					
zai	Isthmus Zapotec	zai					
zaj	Zaramo	zaj					
zak	Zanaki	zak					
zal	Zauzou	zal					
zam	Miahuatlán Zapotec	zam					Central Mahuatlán Zapoteco
zao	Ozolotepec Zapotec	zao					
zap	Zapotec	zap	zap	zap			zapotèque
zaq	Aloápam Zapotec	zaq					
zar	Rincón Zapotec	zar					
zas	Santo Domingo Albarradas Zapotec	zas					
zat	Tabaa Zapotec	zat					
zau	Zangskari	zau					
zav	Yatzachi Zapotec	zav					
zaw	Mitla Zapotec	zaw					
zax	Xadani Zapotec	zax					
zay	Zayse-Zergulla	zay					
zaz	Zari	zaz					
zbc	Central Berawan	zbc					
zbe	East Berawan	zbe					
zbl	Blissymbols	zbl	zbl	zbl			symboles Bliss;Blissymbolics;Bliss
zbt	Batui	zbt					
zbw	West Berawan	zbw					
zca	Coatecas Altas Zapotec	zca					
zch	Central Hongshuihe Zhuang	zch					
zdj	Ngazidja Comorian	zdj					
zea	Zeeuws	zea					
zeg	Zenag	zeg					
zeh	Eastern Hongshuihe Zhuang	zeh					
zen	Zenaga	zen	zen	zen			zenaga
zga	Kinga	zga					
zgb	Guibei Zhuang	zgb					
zgm	Minz Zhuang	zgm					
zgn	Guibian Zhuang	zgn					
zgr	Magori	zgr					
zha	Zhuang	zha	zha	zha	za	za	zhuang;chuang;Chuang
zhb	Zhaba	zhb					
zhd	Dai Zhuang	zhd					
zhi	Zhire	zhi					
zhn	Nong Zhuang	zhn					
zho	Chinese	zho	chi	zho	zh	chi;zh-cn;zh;zh-tw	Chinesisch;Chinesisch (traditionell);Chinesisch (vereinfacht);chinois
zhw	Zhoa	zhw					
zia	Zia	zia					
zib	Zimbabwe Sign Language	zib					
zik	Zimakani	zik					
zil	Zialo	zil					
zim	Mesme	zim					
zin	Zinza	zin					
zir	Ziriya	zir					
ziw	Zigula	ziw					
ziz	Zizilivakan	ziz					
zka	Kaimbulawa	zka					
zkb	Koibal	zkb					
zkd	Kadu	zkd					
zkg	Koguryo	zkg					
zkh	Khorezmian	zkh					
zkk	Karankawa	zkk					
zkn	Kanan	zkn					
zko	Kott	zko					
zkp	São Paulo Kaingáng	zkp					
zkr	Zakhring	zkr					
zkt	Kitan	zkt					
zku	Kaurna	zku					
zkv	Krevinian	zkv					
zkz	Khazar	zkz					
zlj	Liujiang Zhuang	zlj					
zlm	Malay (individual language)	zlm					
zln	Lianshan Zhuang	zln					
zlq	Liuqian Zhuang	zlq					
zma	Manda (Australia)	zma					
zmb	Zimba	zmb					
zmc	Margany	zmc					
zmd	Maridan	zmd					
zme	Mangerr	zme					
zmf	Mfinu	zmf					
zmg	Marti Ke	zmg					
zmh	Makolkol	zmh					
zmi	Negeri Sembilan Malay	zmi					
zmj	Maridjabin	zmj					
zmk	Mandandanyi	zmk					
zml	Madngele	zml					
zmm	Marimanindji	zmm					
zmn	Mbangwe	zmn					
zmo	Molo	zmo					
zmp	Mpuono	zmp					
zmq	Mituku	zmq					
zmr	Maranunggu	zmr					
zms	Mbesa	zms					
zmt	Maringarr	zmt					
zmu	Muruwari	zmu					
zmv	Mbariman-Gudhinma	zmv					
zmw	Mbo (Democratic Republic of Congo)	zmw					
zmx	Bomitaba	zmx					
zmy	Mariyedi	zmy					
zmz	Mbandja	zmz					
zna	Zan Gula	zna					
zne	Zande (individual language)	zne					
zng	Mang	zng					
znk	Manangkari	znk					
zns	Mangas	zns					
zoc	Copainalá Zoque	zoc					
zoh	Chimalapa Zoque	zoh					
zom	Zou	zom					
zoo	Asunción Mixtepec Zapotec	zoo					
zoq	Tabasco Zoque	zoq					
zor	Rayón Zoque	zor					
zos	Francisco León Zoque	zos					
zpa	Lachiguiri Zapotec	zpa					
zpb	Yautepec Zapotec	zpb					
zpc	Choapan Zapotec	zpc					Choapan Zapoteco
zpd	Southeastern Ixtlán Zapotec	zpd					
zpe	Petapa Zapotec	zpe					
zpf	San Pedro Quiatoni Zapotec	zpf					
zpg	Guevea De Humboldt Zapotec	zpg					
zph	Totomachapan Zapotec	zph					
zpi	Santa María Quiegolani Zapotec	zpi					
zpj	Quiavicuzas Zapotec	zpj					
zpk	Tlacolulita Zapotec	zpk					
zpl	Lachixío Zapotec	zpl					
zpm	Mixtepec Zapotec	zpm					
zpn	Santa Inés Yatzechi Zapotec	zpn					
zpo	Amatlán Zapotec	zpo					
zpp	El Alto Zapotec	zpp					El Alto Zapoteco
zpq	Zoogocho Zapotec	zpq					
zpr	Santiago Xanica Zapotec	zpr					
zps	Coatlán Zapotec	zps					
zpt	San Vicente Coatlán Zapotec	zpt					
zpu	Yalálag Zapotec	zpu					
zpv	Chichicapan Zapotec	zpv					
zpw	Zaniza Zapotec	zpw					
zpx	San Baltazar Loxicha Zapotec	zpx					
zpy	Mazaltepec Zapotec	zpy					
zpz	Texmelucan Zapotec	zpz					
zqe	Qiubei Zhuang	zqe					
zra	Kara (Korea)	zra					
zrg	Mirgan	zrg					
zrn	Zerenkel	zrn					
zro	Záparo	zro					
zrp	Zarphatic	zrp					
zrs	Mairasi	zrs					
zsa	Sarasira	zsa					
zsk	Kaskean	zsk					
zsl	Zambian Sign Language	zsl					
zsm	Standard Malay	zsm					
zsr	Southern Rincon Zapotec	zsr					
zsu	Sukurum	zsu					
zte	Elotepec Zapotec	zte					
ztg	Xanaguía Zapotec	ztg					
ztl	Lapaguía-Guivini Zapotec	ztl					
ztm	San Agustín Mixtepec Zapotec	ztm					
ztn	Santa Catarina Albarradas Zapotec	ztn					
ztp	Loxicha Zapotec	ztp					
ztq	Quioquitani-Quierí Zapotec	ztq					
zts	Tilquiapan Zapotec	zts					
ztt	Tejalapan Zapotec	ztt					
ztu	Güilá Zapotec	ztu					San Pablo Güilá Zapotec
ztx	Zaachila Zapotec	ztx					Zaachila Zapoteco
zty	Yatee Zapotec	zty					
zua	Zeem	zua					
zuh	Tokano	zuh					
zul	Zulu	zul	zul	zul	zu	zu	zoulou;isiZulu
zum	Kumzari	zum					
zun	Zuni	zun	zun	zun			zuni
zuy	Zumaya	zuy					
zwa	Zay	zwa					
zxx	No linguistic content	zxx	zxx	zxx			Not applicable;non applicable;pas de contenu linguistique
zyb	Yongbei Zhuang	zyb					
zyg	Yang Zhuang	zyg					
zyj	Youjiang Zhuang	zyj					
zyn	Yongnan Zhuang	zyn					
zyp	Zyphe	zyp					
zza	Zaza	zza	zza	zza			kirdki;dimli;Dimili;kirmanjki;Kirmanjki;Kirdki;zazaki;Dimli;Zazaki;dimili;zaza
zzj	Zuojiang Zhuang	zzj					
afa	Afro-Asiatic languages 		afa	afa	 		Afro-Asiatic languages;afro-asiatiques, langues
alg	Algonquian languages 		alg	alg	 		algonquines, langues;Algonquian languages
apa	Apache languages 		apa	apa	 		apaches, langues;Apache languages;Apache
art	Artificial languages 		art	art	 		artificielles, langues;Artificial languages
ath	Athapascan languages 		ath	ath	 		Athapascan languages;Athapascan;athapascanes, langues
aus	Australian languages 		aus	aus	 		Australian languages;australiennes, langues
bad	Banda languages 		bad	bad	 		Banda;Banda languages;banda, langues
bai	Bamileke languages 		bai	bai	 		Bamileke languages;bamiléké, langues
bat	Baltic languages 		bat	bat	 		baltes, langues;Baltic languages
ber	Berber languages 		ber	ber	 		Tamazigh;Tamazight;Berber languages;Berbersprachen;Berber;berbères, langues
bih	Bihari languages 		bih	bih	bh	bh	Bihari;Bihari languages;Biharisch;langues biharis
bnt	Bantu languages 		bnt	bnt	 		Bantu languages;bantou, langues
btk	Batak languages 		btk	btk	 		batak, langues;Batak languages
cai	Central American Indian languages 		cai	cai	 		amérindiennes de l'Amérique centrale, langues;Central American Indian languages
cau	Caucasian languages 		cau	cau	 		caucasiennes, langues;Caucasian languages
cel	Celtic languages 		cel	cel	 		Celtic languages;celtiques, langues;celtes, langues
cmc	Chamic languages 		cmc	cmc	 		chames, langues;Chamic languages
cpe	Creoles and pidgins, English based 		cpe	cpe	 		Creoles and pidgins, English based;créoles et pidgins basés sur l'anglais
cpf	Creoles and pidgins, French-based 		cpf	cpf	 		créoles et pidgins basés sur le français;Creoles and pidgins, French-based;Seselwa
cpp	Creoles and pidgins, Portuguese-based 		cpp	cpp	 		Creoles and pidgins, Portuguese-based;créoles et pidgins basés sur le portugais
crp	Creoles and pidgins 		crp	crp	 		créoles et pidgins;Creoles and pidgins
cus	Cushitic languages 		cus	cus	 		Cushitic languages;couchitiques, langues
day	Land Dayak languages 		day	day	 		dayak, langues;Land Dayak languages
dra	Dravidian languages 		dra	dra	 		dravidiennes, langues;Dravidian languages
fiu	Finno-Ugrian languages 		fiu	fiu	 		finno-ougriennes, langues;Finno-Ugrian languages
gem	Germanic languages 		gem	gem	 		Germanic languages;germaniques, langues;Urgermanisch;Protogermanisch;Germanisch
him	Himachali languages 		him	him	 		langues himachalis;Himachali languages;langues paharis occidentales;Western Pahari languages
ijo	Ijo languages 		ijo	ijo	 		ijo, langues;Ijo languages
inc	Indic languages 		inc	inc	 		indo-aryennes, langues;Indic languages
ine	Indo-European languages 		ine	ine	 		Indo-European languages;indo-européennes, langues
ira	Iranian languages 		ira	ira	 		iraniennes, langues;Iranian languages
iro	Iroquoian languages 		iro	iro	 		iroquoises, langues;Iroquoian languages
kar	Karen languages 		kar	kar	 		Karen languages;karen, langues
khi	Khoisan languages 		khi	khi	 		khoïsan, langues;Khoisan languages
kro	Kru languages 		kro	kro	 		Kru languages;krou, langues
map	Austronesian languages 		map	map	 		austronésiennes, langues;Austronesian languages
mkh	Mon-Khmer languages 		mkh	mkh	 		môn-khmer, langues;Mon-Khmer languages
mno	Manobo languages 		mno	mno	 		Manobo;Manobo languages;manobo, langues
mun	Munda languages 		mun	mun	 		Munda languages;mounda, langues
myn	Mayan languages 		myn	myn	 		Mayan languages;Mayan;maya, langues
nah	Nahuatl languages 		nah	nah	 		Nahuatl;nahuatl, langues;Aztekisch/Nahuatl;Nahuatl/ Aztekisch;Nahuatl languages
nai	North American Indian languages 		nai	nai	 		North American Indian languages;nord-amérindiennes, langues
nic	Niger-Kordofanian languages 		nic	nic	 		Niger-Kordofanian languages;nigéro-kordofaniennes, langues
nub	Nubian languages 		nub	nub	 		Nubian languages;nubiennes, langues
oto	Otomian languages 		oto	oto	 		Otomian languages;otomi, langues
paa	Papuan languages 		paa	paa	 		papoues, langues;Papuan languages
phi	Philippine languages 		phi	phi	 		Philippine languages;philippines, langues
pra	Prakrit languages 		pra	pra	 		Prakrit languages;prâkrit, langues
qaa-qtz	Reserved for local use 		qaa-qtz	qaa-qtz	 		réservée à l'usage local;Reserved for local use
roa	Romance languages 		roa	roa	 		romanes, langues;Romance languages
sai	South American Indian languages 		sai	sai	 		South American Indian languages;sud-amérindiennes, langues
sal	Salishan languages 		sal	sal	 		salishennes, langues;Salishan languages
sem	Semitic languages 		sem	sem	 		sémitiques, langues;Semitic languages
sgn	Sign Languages 		sgn	sgn	 		langues des signes;Sign Languages
sio	Siouan languages 		sio	sio	 		sioux, langues;Siouan languages;Sioux
sit	Sino-Tibetan languages 		sit	sit	 		Sino-Tibetan languages;sino-tibétaines, langues
sla	Slavic languages 		sla	sla	 		slaves, langues;Slavic languages
smi	Sami languages 		smi	smi	 		Sami;Sami languages;sames, langues
son	Songhai languages 		son	son	 		Songhai languages;songhai, langues
ssa	Nilo-Saharan languages 		ssa	ssa	 		Nilo-Saharan languages;nilo-sahariennes, langues
tai	Tai languages 		tai	tai	 		Tai languages;tai, langues
tup	Tupi languages 		tup	tup	 		tupi, langues;Tupi-Sprachen;Tupi languages
tut	Altaic languages 		tut	tut	 		altaïques, langues;Altaic languages
wak	Wakashan languages 		wak	wak	 		wakashanes, langues;Wakashan languages
wen	Sorbian languages 		wen	wen	 		Sorbian languages;Sorbian;sorabes, langues
ypk	Yupik languages 		ypk	ypk	 		yupik, langues;Yupik languages
znd	Zande languages 		znd	znd	 		zandé, langues;Zande languages
Xeur	Europanto					eur	
Xart-rom	Romanica						
Xart-tok	Toki Pona						tokipona
ast-leo	Leonese					ast_leo	
bat-smg	Samogitian					bat_smg	
Xbns	Binisayâ						
chs	Chumash						
Xdog	Dogon						
ell-gri	Salentine Greek					el_it;el-it	
eml	Romagnolo					eml_rom;eml-rom	
fra-jer	Jèrriais						
Xglo	Glosa					gs	Glosa/Interglossa
kjl-zkm	Maikoti						
Xmul	Translingual						International
nap-cal	Calabrese					nap_cal	
oci-prv	Provençal					prv	Provenzalisch
por-br	Brasilian Portuguese					pt_br;pt-br	Brasilianisch
sic	Malinguat						
Xsimple	Simple English					simple	
str-saa	Saanich					str_saa	
twf-tao	Taos					twf_tao	
yue-can	Cantonese					yue_can;zh-yue	
